Gd^Fp, Gd, Gd^Fp, Gd, Gd, Gd^Fp, Md, Gd, Rb, Rb, Rb, Rb, Hh, Hh^Fp, Md, Gd, Rr^Efm, Md, Md, Md, Md, Wwg, Md, Md, Md, Gd, Md, Gd^Fp, Gd^Fdw, Gd^Fdw, Gd^Fp, Rr, Rr, Gd^Fp, Gd, Gd, Gll^Efm, Gd^Efm, Gd^Efm, Gd
Gd^Fp, Gd^Efm, Gd, Gd, Gll, Gll^Fp, Gll^Fp, Gd, Rr^Es, Rr^Es, Rr^Es, Md, Hh, Md, Rr, Rr^Efm, Rr, Rr^Efm, Md, Md, Gd, Md, Hhd, Hhd, Md, Gll, Gd, Gd^Fp, Hhd^Fp, Hhd^Fp, Gd^Fp, Gd^Fp, Hhd^Fp, Hhd^Fp, Hhd^Fp, Gll^Efm, Md, Md, Gd^Fp, Gd^Fp
Gd^Fp, Gd, Gd^Efm, Rb^Dr, Rb^Efm, Rb^Efm, Rr, Rr, Gll, Gll, Gd^Es, Rr, Gd^Es, Rr, Gd^Fp, Gd^Es, Rr, Gd^Esd, Gd^Esd, Md, Gd^Esa, Hhd, Wwg, Md, Wwg, Gll^Esa, Gll, Gd, Gs^Es, Gs, Gd^Fp, Gd^Vo, Hhd^Fp, Md, Md, Md, Md, Md, Gd^Fp, Gd^Fp
Gd^Fp, Ds, Rb, Rb^Efm, Rr, Rr, Gs, Gd^Fp, Gs^Fp, Gs^Fp, Ds, Ds, Gd^Es, Gd^Fp, Gd^Ve, Gd^Fp, Hhd^Em, Rr^Es, Rr^Es, Gd^Esa, Aa, Hhd^Esa, Wwrg, Wwg, Hhd^Es, Hhd^Esa, Gd^Efm, Gd, Gd, Gd, Gd^Fdw, Gd^Fp, Gll^Feth, Co^Edb, Co, Co, Md, Md, Md, Gll^Feth
Ds, Ds, Ds, Md, Md, Gs, Gd^Fp, Md, Gd^Fdw, Ds, Ds, Gd^Esd, Gd^Efm, Gd^Efm, Gd^Fp, Gd^Fp, Gg, Hhd^Em, Ds, Rr, Wwf, Wwf, Wwf, Wwf, Hhd^Es, Gd^Efm, Gll^Efm, Gll^Efm, Gll^Efm, Gll^Fp, Gd^Vo, Gd^Fp, Gd^Ecf, Co^Edb, 4 Ko, Co^Edb, Md, Md, Md, Md
Gd, Ds, Hh, Hh, Gd, Gs, Gd^Fp, Gd^Fp, Gg^Fet, Gd^Fdw, Gd^Esd, Gs, Gd^Efm, Gd^Fdw, Gd^Fp, Gs, Hhd^Em, Gs, Ds^Es, Wwf^Es, Hh^Em, Hhd^Es, Hhd^Es, Wwf^Es, Wwrg, Ds, Wwg, Gd^Es, Wwf, Wwf^Wkf, Hh^Edb, Hh, Co^Edb, Co^Edb, Co, Hhd^Fp, Md, Md, Hhd^Fp, Gd
Gd^Fp, Hh, Hh^Fp, Hh^Fp, Hh^Fp, Gd^Fp, Md, Md, Md, Gd^Fdw, Gll, Gd^Efm, Gd^Efm, Gd^Fp, Md, Hhd^Em, Md, Md, Ds^Edb, Wwf, Hh^Em, Hh^Emf, Hhd^Es, Wwf, Wwrg, Ds, Wwg, Wwg, Ds^Edb, Wwg, Wwf, Hh^Edb, Hhd^Emf, Gll, Md, Md, Gd^Fp, Hhd^Fp, Gll^Fdw, Gd^Fp
Hh, Hh, Md, Md, Md, Md, Md, Md, Md, Gll^Fdw, Gll, Gd, Hhd^Fp, Gs, Gs^Fp, Md, Ds, Hhd^Em, Ds, Wwf, Wwg, Hh^Em, Hhd^Es, Wwf^Wkf, Md, Wwrg, Hhd^Es, Wwg, Wwg, Ds^Edb, Ds, Ds^Em, Hhd^Em, Md, Gd^Fp, Md, Gll^Edb, Hhd, Gll^Es, Gd^Efm
Rr, Gd^Fp, Gd^Fp, Hh^Fp, Gd^Fp, Md, Md, Md^Xm, Gd^Fp, Gd^Fdw, Hhd^Fp, Hhd^Fp, Gd, Gs, Gs^Efm, Md, Ds^Edb, Wwg, Wwf, Wwrg, Wwrg, Hh^Em, Wwf^Wkf, Wwf^Wkf, Md, Hhd^Es, Md, Hhd^Es, Md, Md, Hh, Md, Hhd^Em, Md, Hhd^Fp, Hhd^Fp, Gd^Edb, Gll^Edb, Gd, Gd
Rr, Gd^Fdw, Gd^Fp, Gd^Fp, Md, Hhd^Fp, Hhd^Fp, Md, Hhd, Hhd^Fp, Md, Hhd^Fp, Hhd^Edt, Gd^Edt, Re^Efm, Re, Wwf, Wwf, Wwf, Wwf, Wwrg, Wwg^Ewf, Wwg, Ds^Dr, Ds, Gd^Fp, Md, Rb, Md, Hh, Hh^Em, Hh^Em, Hh^Em, Hhd^Em, Hhd^Em, Hhd^Fp, Gd^Es, Gd^Edb, Gd^Edb, Gd^Edb
Gd^Fp, Gd^Fdw, Gd^Fp, Md, Gs^Fdw, Gd^Efm, Gd^Efm, Hhd, Gd^Em, Hhd^Em, Hhd^Em, Hhd^Em, Gd, Gd^Edt, Re, Wwrg, Wwf, Ds, Ds^Em, Wwg, Wwrg, Wwg, Hh^Em, Wwg, Gd, Rb, Aa^Feta, Aa, Aa, Ha, Hh, Hh^Em, Hh^Esa, Hhd, Hhd^Em, Gll^Fdw, Hhd, Hhd^Em, Gll^Fdw, Gs^Fp
Gd^Fdw, Gs^Fdw, Gs^Fp, Gs^Fdw, Gd, Gd^Efm, Gd^Em, Gd^Em, Gll^Emf, Gd^Efm, Gd^Ecf, Gs, Gd^Dr, Re, Re, Wwg, Wwg^Ewl, Wwf^Es, Ds^Em, Wwg, Wwf, Hh^Emf, Hh^Em, Gd^Vh, Gd, Aa, Aa, Re, Gd^Esa, Hh, Hh, Hh^Esa, Hhd^Emf, Hhd^Esa, Hh^Esa, Hhd, Hh, Hhd^Em, Hh^Em, Hh^Em
Gd, Gd^Fp, Gd^Ve, Gs^Fdw, Gd, Re^Esa, Re, Aa^Es, Aa^Esa, Gll^Es, Gd^Efm, Gs^Edb, Gs^Edb, Gd^Edt, Gd^Edb, Ds, Wwg^Ewl, Wwg^Wkf, Ds, Hhd, Wwf, Hh^Em, Hh, Gd, Gd^Efm, Aa, Re^Efm, Re^Esa, Gd, Gd^Esa, Hh, Hh^Em, Hh, Hh^Em, Hh, Md, Hh, Hh^Em, Hh, Hh
Gd^Fp, Gd^Fp, Gd^Fp, Gd^Fp, Gd, Gll^Esa, Re^Em, Aa, Ch, Chr^Esa, Chr, Md^Em, Gs^Edt, Gd^Edt, Gd^Es, Gs^Fp, Wwg^Wkf, Wwf, Wwf, Hhd, Hhd, Wwf, Wwf, Gd, Gs^Efm, Aa, Re^Efm, Rb, Gd^Efm, Gd, Gs^Efm, Hh, Hh, Md, Md, Md^Xm, Md^Xm, Md, Md, Md
Gd, Rb, Rb, Rb, Gd^Em, Rb^Em, Aa, Aa, Ch^Esa, 2 Kh, Ch, Md, Gs, Gd^Edb, Gll^Es, Wwg^Wkf, Wwf, Wwf, Md, Md, Hhd^Emf, Wwf, Hhd^Edt, Gd, Gg^Efm, Aa, Gd^Efm, Gd, Rb^Efm, Gg^Efm, Gs, Hh^Efm, Hh, Md^Xm, Md, Md, Md, Md^Xm, Md, Md
Gs, Gg, Gs, Gd^Efm, Rb, Rb^Em, Aa, Aa, Aa, Ch^Esa, Md, Md, Gd, Gd^Em, Gll^Em, Wwf, Wwf, Md, Md^Xm, Md, Md, Hhd^Emf, Hhd, Gd, Gg, Aa, Gd, Gd, Gd^Em, Gg^Emf, Gs^Em, Hh^Em, Hhd^Vhh, Hh, Md, Md, Md, Md, Md^Xm, Md
Hhd^Em, Md, Gd^Efm, Gd^Em, Gll, Aa, Aa^Esa, Rb^Efm, Rb^Efm, Rb, Gll^Emf, Gll, Gd^Vh, Gll, Hhd, Md, Md, Md^Xm, Md, Md, Md, Hhd^Emf, Hhd, Gd, Aa, Aa, Gd^Edt, Gs^Esd, Gs, Gg^Em, Gs^Edt, Hh, Hh, Hh, Md^Xm, Md, Md, Md^Xm, Md^Xm, Md^Xm
Hhd^Em, Md, Md^Em, Gd^Efm, Gd, Gd^Edt, Aa, Gd^Vh, Gd, Gd^Efm, Gd, Gd, Gd, Hhd, Hhd, Md, Md, Md, Md^Xm, Md, Hhd^Em, Hhd, Hhd, Hhd^Edt, Gd^Edt, Gd^Edt, Gd, Md, Md, Gs^Edt, Gs^Edt, Hh, Md, Md, Md, Md, Hh^Em, Md, Md, Md
Md, Hhd^Em, Hhd^Esa, Gd^Efm, Aa, Aa, Aa, Hhd^Esa, Gd^Esa, Gll^Fdw, Gll^Fdw, Gll, Hhd, Hhd, Hhd, Md, Md^Xm, Md^Xm, Md, Md, Hhd, Hhd, Hhd^Edt, Hhd^Edt, Rb, Gll^Feth, Gd^Edt, Aa, Md, Gs^Efm, Gd^Edt, Hh, Md, Md, Md, Md, Hh^Em, Md, Hh^Em, Md
Md, Hhd, Md, Hhd, Ha, Ha, Aa, Ha, Hhd, Gd^Fetd, Hhd^Es, Hhd, Hhd, Hhd, Md^Xm, Md, Md, Md, Md^Xm, Hhd, Hhd, Hhd, Gll^Fdw, Gll^Fdw, Gll^Fdw, Rb, Gd, Aa, Rb^Esa, Gd^Edt, Hh, Hh, Md, Md, Md^Xm, Md, Md, Hh^Em, Hh, Hh
Md, Md^Xm, Md, Md, Ha^Esa, Hhd^Esa, Gll, Hhd, Gd^Efm, Gd, Hhd^Emf, Md, Md, Md, Md^Xm, Md^Xm, Md^Xm, Md, Md, Md, Hhd, Gd, Gd^Fp, Md, Md, Gs, Gd^Em, Gd, Rb, Gd^Em, Hh, Md^Xm, Md, Md, Md^Xm, Md^Xm, Md^Xm, Hh, Hh^Em, Hh
Md, Md, Md^Xm, Hhd, Ha^Esa, Hhd^Em, Gll^Em, Gd, Hhd, Gd, Gd, Md, Md^Xm, Md, Md, Md, Md, Md, Md, Wwrg, Wwf^Ewl, Gll, Md, Gd^Fp, Gd^Fp, Gs^Efm, Gd^Em, Gll, Gd^Fdw, Gll^Em, Gd, Gd, Gd^Em, Md, Md, Md, Md, Hh, Hh, Md
Gd^Fp, Md, Md, Md, Gd, Gll^Em, Gd^Efm, Gd^Efm, Gs, Hhd^Es, Md, Md, Md, Md, Md, Md, Md, Md, Wwrg, Wwrg, Wwf^Wkf, Gll, Gll, Gs, Rb^Efm, Gs^Efm, Md, Gd^Fdw, Gd^Em, Gll^Em, Hh^Emf, Hh, Gd, Md, Gd^Em, Md, Md, Hh, Hh, Md
Gd^Fp, Gd^Fp, Gll^Em, Gd, Gd, Gd, Gd^Efm, Aa, Gd^Efm, Gd^Efm, Gd^Efm, Md, Md, Md, Md, Md, Md, Wwrg, Wwg^Wkf, Wwf, Ai, Wwf^Wkf, Gd^Edt, Gs, Gd^Efm, Gd^Fp, Gll, Gd^Fdw, Gd, Gd, Gs^Es, Gd^Es, Gd, Gd, Gs^Efm, Gs, Hh, Hh, Rb, Rb
Wwrg, Gd^Ve, Gd^Fp, Gll^Fp, Gll, Gd, Gd, Aa, Gll^Fdw, Gd^Efm, Gd^Efm, Md, Md, Md, Md, Md, Md, Wwg, Wwf^Wkf, Wwf, Ai, Ai, Ai^Esa, Gd^Edt, Gd^Esd, Gd, Gg, Gd^Fp, Gll^Fp, Gd^Es, Gs, Gs^Es, Gll^Em, Md, Md, Md, Gd, Gg, Gg^Efm, Gs
Gd^Fp, Wwg, Gd^Fp, Gd^Fp, Ch, Gll^Es, Gg, Gd^Fdw, Gd^Fdw, Hhd^Fp, Gd^Efm, Hhd^Es, Md, Md^Xm, Md, Md, Md^Xm, Hhd, Wwf, Wwf, Ai, Ai^Esa, Aa^Esa, Gll^Edt, Gd^Esa, Md^Xm, Md, Gd^Fdw, Gg^Fet, Gd, Gd, Gll^Em, Gs, Gll^Em, Gll^Em, Gll^Em, Md, Gd^Edt, Gd^Edt, Gd^Edt
Wwg, Wwg^Wkf, Gll^Edt, Ch, 1 Kh, Ch^Es, Re^Es, Gd^Ecf, Gd, Rb, Gd^Efm, Hhd^Dr, Hhd, Md, Hhd^Edt, Md^Xm, Hhd^Edt, Hhd^Edt, Wwf^Es, Ai, Ai, Aa, Aa, Aa^Esa, Rr, Gd^Esa, Gll^Fp, Gll^Fp, Gg, Gs^Efm, Gs^Efm, Gs^Efm, Gg^Efm, Gs, Gs, Rb^Efm, Rb^Vhc, Gd^Es, Md, Gd^Fp
Gll^Fdw, Wwg^Wkf, Gd^Ve, Chr^Edt, Chr, Chr, Wwf, Re^Efm, Gd^Efm, Re, Hhd^Em, Hhd^Emf, Hhd^Em, Hhd, Hhd, Wwrg, Wwf^Es, Wwf^Es, Re^Efm, Ai, Ai^Esa, Aa, Aa, Aa, Aa^Edt, Rr, Rr, Rr, Rr, Gg^Efm, Rr^Es, Md, Gs, Md, Chr, Md, Rb^Efm, Rb, Rb, Gd^Fp
Wwrg, Gll^Fdw, Gd^Fdw, Gd^Fetd, Gll^Fmw, Wwf, Wwg, Wwf, Wwg^Wkf, Re, Re, Hhd^Vhh, Gll^Fp, Md, Wwrg, Wwrg, Wwf^Wkf, Wwf, Re, Wwrg, Wwf^Bw/, Ch, Gd^Edt, Gd^Efm, Gd^Efm, Gd^Efm, Hhd^Em, Hhd^Em, Md, Rr^Es, Md, Rr^Es, Hh^Efm, Chr^Efm, 3 Kh, Ch, Gd^Efm, Md, Rb, Gd^Fp
Wwrg, Rb, Rb^Em, Rb^Edt, Gd^Edb, Wwrg, Gd^Fp, Gll^Fp, Gll^Fp, Wwg^Wkf, Wwrg, Hhd^Fp, Re, Gll^Fp, Gs^Em, Re^Emf, Re^Em, Re, Rr, Wwrg, Wwf, Gll, Gd^Efm, Gll, Gg, Hhd, Hhd^Em, Md, Md, Md, Md, Rr, Rr, Chr^Efm, Ch^Es, Chr, Rr^Vhc, Gd^Es, Hhd^Em, Gd
Wwg, Gll^Emf, Gd^Edt, Gd^Edt, Rb^Es, Wwg, Gd^Fp, Gd^Em, Gll^Fp, Wwg^Wkf, Wwrg, Re, Gd, Gs^Es, Gd, Gs^Es, Gs^Es, Rr, Gll^Fp, Gll, Wwf^Es, Gll^Es, Gd^Efm, Gll^Fdw, Gd^Fp, Hhd^Em, Hhd^Em, Md, Md, Md, Md^Em, Hhd^Em, Hhd^Em, Rr^Es, Rr, Gd^Fp, Gd^Fp, Hhd^Em, Rr, Hhd
Gll^Em, Gll^Em, Gd^Fdw, Gll, Gll^Es, Wwrg, Gll^Fp, Gd^Fp, Wwg^Ewf, Wwrg, Wwg, Re, Gll, Gd, Wwg^Wkf, Gd, Ch, Rr, Gll^Fp, Wwf, Wwg^Wkf, Gll^Fdw, Gll^Fdw, Gll^Fdw, Hhd, Hhd, Md, Md, Md, Md, Ha, Hhd, Gll^Em, Rr^Vhc, Gd^Efm, Rr, Rr, Rr, Gd^Es, Rr
Gd, Gd^Fdw, Wwrg, Gd^Fdw, Wwg^Wkf, Wwrg, Gd^Fp, Hhd, Hhd, Wwg, Wwg, Wwf, Wwg, Wwg^Wkf, Gll^Fp, Wwg^Wkf, Rr, Wwg^Ewl, Wwrg, Wwg, Gll^Fp, Gd^Fp, Md, Gd^Fp, Hhd, Md, Md, Md, Md, Hhd, Ha, Hhd^Em, Rb^Emf, Gll^Fp, Gd^Fp, Gd^Efm, Gll^Efm, Gd^Efm, Gll^Edt, Gll^Es
Gll, Gll^Em, Wwf, Wwf, Wwf, Wwg, Gd^Fp, Hhd, Hhd, Hhd, Hhd, Gll, Hhd, Gd^Fp, Hhd, Gll^Fp, Rr, Wwg, Gd, Wwrg, Wwg, Gd^Fp, Gd^Fp, Gd^Fp, Hhd, Md, Md, Md, Md, Md, Ha, Hhd, Hhd^Fp, Gd^Fp, Gd^Fp, Gd, Gd, Gll, Gll, Gll^Edt
