Md, Md, Md, Md, Md, Md, Md, Md, Md, Md, Md, Md, Md, Hhd, Rr, Hhd, Md, Md, Md, Md, Md, Md, Md^Xm, Md, Hhd, Wwf, Hhd, Hhd, Md, Md, Md, Hhd, Md, Md, Md, Md, Md, Md
Md, Md, Md, Md, Md, Md, Md, Md, Md, Md, Md, Md, Md, Hhd, Rr, Hhd, Hhd^Dr, Md, Md, Md, Md, Md, Md, Md, Hhd, Wwf, Wwf^Wkf, Hhd, Hhd^Vo, Md, Hhd, Hhd, Hhd, Md, Md, Md, Md^Xm, Md
Md, Md, Md, Md, Md^Xm, Md, Md, Md, Hhd^Fdw, Md, Md, Md^Xm, Md, Hhd, Rr, Hhd, Gd, Hhd, Hhd, Md, Md, Md, Hhd, Md, Hhd, Hhd, Wwrg, Wwf^Ewl, Wwf, Hhd, Co, Co, Co, Hhd^Voa, Md, Md, Md, Md
Md, Md, Md, Md, Md, Md, Hhd^Vhh, Md, Hhd^Fmw, Hhd^Fdw, Hhd, Md, Hhd, Hhd, Rr, Gd^Efm, Gd^Fdw, Re, Wwf, Hhd^Fdw, Hhd, Hhd, Wwf^Ewl, Hhd^Dr, Wwg^Wkf, Wwrg, Gll^Edt, Wwrg, Hhd, Hhd^Es, Co, 4 Ko, Co, Hhd, Hhd^Dr, Md, Md, Md
Hhd, Md, Md, Md, Md, Md, Hhd, Hhd, Re^Fdw, Hhd, Re^Esa, Hhd^Esa, Rra, Rra^Esa, Gd^Efm, Gd^Efm, Gd^Fdw, Re, Wwg, Wwf, Wwrg, Wwrg, Gll, Wwf, Gll^Edt, Gll^Edt, Re, Wwf^Ewl, Wwf, Hhd^Es, Hhd^Es, Co, Hhd^Es, Hhd, Md, Md^Xm, Md, Hhd
Rb, Hhd, Hhd, Md, Hhd, Hhd^Esa, Re, Re, Rr, Re, Rra, Rra, Gd^Esa, Gd, Gs^Ve, Gg, Gll, Gll, Gll, Wwg^Wkf, Wwrg, Gll, Gs, Gll, Re, Re^Esa, Aa, Hhd^Esa, Hhd, Hhd, Gll^Ecf, Hhd^Es, Hhd, Hhd, Hhd, Md, Hhd, Hhd
Rra^Esa, Rb^Esa, Rb, Hhd^Fmw, Re, Re^Esa, Rra^Esa, Rr, Gd, Rr, Gd^Em, Gs, Gd^Fdw, Gd^Esa, Gll, Gll, Wwf^Ewf, Wwf, Wwf^Ewl, Wwg, Gs, Gs, Gd^Efm, Gd^Fet, Gs^Fet, Gd, Aa, Hhd^Esa, Aa, Hhd, Gll, Gs^Voa, Hhd, Md, Md, Hhd, Md, Md
Gd, Rra^Esa, Rr, Re, Rr, Rra^Esa, Gd^Fetd, Gd^Fdw, Gd, Rr, Gd, Gd^Efm, Gd^Fdw, Gll^Esa, Wwf, Wwf, Wwrg, Wwg, Wwf^Wkf, Gll, Gll, Gll, Gll, Gd^Efm, Gs^Ve, Aa^Fpa, Aa, Aa, Gd^Edt, Gll, Hhd, Hhd, Md, Md, Md, Md, Md^Xm, Md
Hhd, Gs, Gd, Rr, Gd, Gd, Gd^Fdw, Gd^Fdw, Gd^Vh, Rr, Gd, Gll^Fdw, Gll^Fmw, Gll, Gll, Wwrg, Gll, Rb, Gll, Wwf^Wkf, Wwf^Ewl, Wwf, Wwf, Gll, Wwf, Gd, Gd^Fdw, Gd, Gd^Fp, Gll, Hhd^Fdw, Md, Md, Md, Md, Md, Md, Md
Md, Hhd, Gll, Gll^Fdw, Gd, Gs, Aa, Gd^Es, Chr, Rr^Es, Gd^Es, Gd, Gll, Gll, Gd, Gd^Fms, Gll, Gll^Efm, Wwf, Wog, Wwrg, Gll, Gll^Edt, Wwf, Wwrg, Gll, Rb, Gd^Fdw, Gd^Em, Gll, Hhd^Fdw, Md, Md, Md, Md, Md, Md^Xm, Md
Md, Hhd, Hhd^Fmw, Gll, Gd, Aa, Aa, Chr, 2 Khr, Chr, Gll^Es, Gll^Ecf, Gd, Chr, Gd, Gll^Fdw, Wwf, Wwg, Wwrg, Wwf, Wwf, Wwf, Wwf, Gll, Gll, Re, Rb, Gd^Em, Re, Re, Hhd, Md, Md, Md, Md, Md, Md, Md
Md, Md, Md, Hhd^Fmw, Gd^Fdw, Gd, Aa, Ch, Ch, Ch, Gd^Edt, Gll^Vh, Gd^Edt, Wwg, Gd, Gll, Gll, Wwf^Ewl, Wwg^Wkf, Wog, Wwg^Wkf, Wwg^Wkf, Wwf^Ewl, Gll, Wwf^Ewl, Re, Rb, Gd, Re, Aa^Feta, Aa, Hhd, Md, Md, Md, Md, Md^Xm, Md
Md, Md, Md, Hhd^Fdw, Hhd, Gs, Aa, Aa^Feta, Aa, Aa, Aa, Gd^Edt, Wwf, Wwg^Wkf, Gg, Wwf, Wwf, Wwf^Wkf, Wwf, Wog^Bw/, Wog, Wwrg, Wwrg, Wwf^Ewl, Wwrg, Re, Gd^Fp, Gg^Efm, Gd^Efm, Re, Aa, Hhd, Hhd, Md, Hhd^Dr, Md, Md, Md
Md, Md, Md, Md, Hhd, Gd, Gd, Aa, Gd^Vla, Gd, Gd^Em, Gd, Gll^Edt, Wwf, Wwrg, Gs, Gd, Gll, Wog, Gll^Fdw, Gll^Fmw, Wwf, Wwf, Wwrg, Re, Re, Gd, Gd^Fdf, Gd^Efm, Re, Re, Aa, Hhd^Fmw, Hhd, Md, Hhd, Hhd, Hhd
Md, Md, Md, Md, Md, Hhd, Gd, Gd, Gll^Fdw, Gd, Gs, Gd, Gll, Wwf, Wwf^Ewl, Wwrg, Wwg^Wkf, Wwg^Wkf, Wog^Bw/, Wwf^Ewl, Gll, Gd^Dr, Gd, Gd^Em, Gll, Gll, Gll^Edt, Gd, Gd, Gd^Efm, Hhd, Hhd^Fpa, Md, Md, Md^Xm, Md, Md, Md
Hhd, Md, Hhd, Md, Md, Hhd, Gd, Gll^Fdf, Re^Fdf, Gll^Efm, Gg, Gg, Gd^Efm, Gll, Gll, Wwf^Ewl, Gll, Wog^Bw/, Wwrg, Wwf^Ewl, Wwg^Ewl, Gll, Gll^Vct, Gll, Wwf, Wwf, Wwf, Gll, Gs, Gg, Gd, Hhd, Hhd^Fmw, Md, Md, Md, Md^Xm, Md
Gd, Hhd, Gg, Hhd, Hhd, Hhd, Gd, Gd^Efm, Gd^Fdf, Re^Efm, Gd^Efm, Gd^Efm, Gll, Gll, Gll, Gll, Gd, Wwf, Wwrg, Wwf^Ewf, Gll, Wwrg, Wwg, Wwf, Gll, Wwg^Wkf, Gll, Gll^Edt, Gll^Edt, Gd^Edt, Gd^Wm, Gd, Hhd, Hhd, Hhd, Md, Md, Md
Hhd, Gs, Hhd, Gd, Gd, Gd, Gd, Gd, Gll, Gd^Efm, Gll, Gll, Hhd, Hhd, Hhd, Gd^Vea, Gd, Wwf, Wwrg, Gll, Re, Gll^Em, Gll, Gll, Gd, Wwrg, Wwf^Ewl, Gll, Wwg^Ewl, Gll, Gll, Gs, Rr, Rr, Rr, Hhd, Hhd, Hhd
Md, Hhd, Md, Hhd^Esa, Hhd^Fdw, Gd^Esa, Gd^Fdw, Gs, Cha, Gll, Gll^Fdw, Hhd, Md, Md^Xm, Md, Hhd, Gd, Wwf^Ewl, Wwf, Aa^Fpa, Re^Fetd, Wwf, Wwf^Wkf, Wwf^Ewl, Gs, Wwg, Gll, Wwf^Ewf, Wwf^Ewl, Wwrg, Gd^Em, Gg, Rr, Hhd^Esa, Hhd, Rr, Rr, Hhd
Md, Md, Md, Md, Md, Hhd^Fdw, Hhd, Gd, Gs, Re, Gll, Hhd^Fdw, Md, Md, Md, Hhd, Hhd, Gd, Gd, Gd^Fpa, Gd^Fet, Gll^Fmw, Wwg, Wwrg, Wwrg, Gd, Gd^Efm, Gd, Gd^Vhc, Gd^Esa, Rra^Esa, Rra^Esa, Hhd^Esa, Hhd, Md, Hhd, Hhd, Rr
Md, Md, Hhd, Md, Md, Md, Hhd, Gd, Gd, Re^Fdw, Gll, Hhd^Fdw, Md, Md, Md, Md^Xm, Md, Hhd, Re, Gs^Efm, Gs^Efm, Gll^Fet, Gll^Fet, Wog, Gll, Gll, Gd^Esa, Gd^Efm, Aa^Fpa, Rra, Hhd, Hhd^Esa, Md, Md, Md, Md, Hhd^Dr, Gd
Md, Md, Hhd^Dr, Hhd, Hhd, Hhd, Gs, Gd^Em, Gd, Re, Re^Esa, Hhd, Hhd, Hhd, Aa, Md, Hhd, Hhd, Hhd^Fdw, Re, Re, Gd^Efm, Gd, Gll, Gd^Efm, Cha, Aa, Aa, Ch, Aa, Hhd^Es, Md, Md, Md, Hhd^Esa, Md, Hhd, Hhd
Hhd, Hhd, Hhd, Aa, Aa, Aa^Vla, Aa, Gd^Em, Gd, Gd, Re^Fdw, Aa, Aa, Aa^Vca, Hhd, Hhd^Fds, Md, Md, Md, Hhd, Hhd, Re, Gg, Gs, Gd^Efm, Aa, Aa, Ch, 3 Kh, Ch, Hhd^Es, Hhd^Fdw, Md, Md^Xm, Md, Hhd, Md, Hhd
Md, Hhd, Aa, Hhd, Chr, Aa^Fpa, Aa, Gd, Gll^Edt, Gs^Fet, Gg^Fet, Gd, Re^Esa, Re^Esa, Hhd, Md, Md, Md, Md, Md, Hhd, Re, Gll, Gd, Gd, Gd^Vhc, Aa, Ch, Ch, Ch, Hhd^Es, Hhd^Fdw, Md, Md, Md, Md, Md, Md
Hhd, Hhd, Aa^Vca, Chr, 1 Khr, Ch, Re^Es, Re, Gll, Gd^Edt, Gd, Gd^Efm, Gd^Efm, Re, Hhd^Fdw, Md, Md, Md, Hhd, Hhd, Gll, Gll, Hhd^Fp, Gll, Hhd, Gd, Gd^Esa, Rra, Hhd, Hhd^Es, Md^Xm, Hhd, Md, Md, Md, Md, Md, Md
Hhd, Hhd, Hhd, Chr, Ch, Ch, Re^Es, Gll^Ecf, Gs, Gd^Edt, Gd, Re^Fdw, Gll, Re, Re^Fdw, Hhd^Fdf, Hhd^Fdw, Hhd, Re, Re, Gll, Hhd, Md, Hhd^Fp, Md, Hhd, Gd^Esa, Rra^Esa, Hhd^Fmw, Md, Md, Md, Hhd, Md, Hhd, Hhd, Hhd, Md
Md, Hhd, Hhd, Hhd, Hhd^Esa, Hhd^Es, Re, Re, Gd, Gd, Gll, Gll, Hhd, Gll, Gll, Re, Re, Re, Gll, Gll, Hhd, Hhd, Hhd^Vhh, Md, Md, Hhd, Gs, Rr, Rr, Hhd^Fdw, Hhd^Fmw, Md, Hhd, Hhd^Esa, Md^Xm, Md, Md, Hhd
Md, Md, Md, Hhd, Hhd, Re, Gll, Gll^Fdw, Gll, Gll, Hhd^Esa, Hhd, Md, Hhd, Hhd, Gll, Gg, Gd^Em, Hhd, Hhd, Md, Md, Md, Md, Md, Hhd, Hhd, Gg, Gd, Rr, Rr, Hhd, Hhd, Md, Md, Md, Md^Xm, Md
Md, Md, Md, Md, Md, Hhd, Hhd, Hhd, Hhd, Hhd^Esa, Md, Md, Md, Md, Hhd, Gll, Gd, Gd, Hhd, Md, Md, Md, Md, Md, Md, Md^Xm, Md, Hhd, Gll, Re^Fdw, Gs, Rr, Rr, Hhd, Hhd, Md, Md, Md
Md, Md, Md, Md, Md, Md, Md, Md, Md, Md, Md, Md, Md, Md, Hhd, Hhd, Rr, Hhd, Hhd, Md, Gd, Md, Md, Md, Md, Md, Md, Hhd, Hhd, Gll, Gll, Gd, Gd, Rr, Gd, Hhd, Hhd, Md
