Gll^Fdw, Gll^Fdw, Gd^Fp, Gd, Gll^Fdw, Gd^Fp, Md^Qhh, Md^Qhh, Md^Qhh, Md^Qhh, Gll^Qhhf, Gll^Qhhf, Hhd^Qhh, Hhd^Qhh, Hhd^Qhh, Md, Rr, Md, Md, Md, Md, Gll, Md, Md, Md, Gd, Md, Gd^Fp, Gd^Fdw, Gd^Fdw, Gd^Fp, Md, Md, Md, Gll, Md, Md, Md, Md, Md
Gll^Fdw, Gll^Fdw, Md, Gd, Gd, Gd^Fp, Hhd^Qhh, Md^Qhh, Rb^Qhh, Rb^Qhh, Rb^Qhh, Rb^Qhhf, Hhd^Qhh, Hhd^Qhh, Hhd^Qhhf, Hhd^Qhhf, Rr, Md, Md, Md, Md, Gll, Md, Md, Hhd, Gd, Md, Gd^Vo, Gd^Fdw, Gd^Fdw, Gd^Fdw, Rr, Rr, Md, Gll, Gll, Gd, Gd^Efm, Gd, Md
Gd^Fdw, Gll, Gd, Gd, Gll, Gd^Fdw, Gll^Fp, Gd^Qhh, Rr^Es, Rr^Es, Rr^Es, Md^Qhh, Hhd^Qhh, Md^Qhh, Rr, Rr, Rr, Rr, Md^Qhh, Md, Gd, Md, Hhd^Qhhf, Hhd, Md, Gll, Gd, Gd^Fp, Gll^Feth, Co^Edb, Co, Co, Hhd^Fp, Hhd^Em, Hhd^Fp, Gd, Hhd, Hhd, Gd^Fp, Md
Gd^Fp, Gd, Gd, Rb^Dr, Rb, Rb, Rr, Rr, Gll, Gll, Gd^Es, Rr, Aa, Rr, Gd^Fdw, Gd, Rr, Gd^Qhh, Gd^Esd, Md^Qhh, Gll^Qhh, Hhd^Qhhf, Gll^Qhh, Hhd^Qhhf, Gll, Gll^Esa, Gd^Vo, Gll, Gd^Fdw, Co, 4 Ko, Co, Hhd^Fp, Hhd, Hhd, Hhd, Hhd, Hhd, Gd^Fdw, Gd^Fp
Gd^Fdw, Ds, Rb, Rb, Rr, Rr, Gll, Gd^Fdw, Gll^Fp, Gd^Fdw, Ds, Ds, Aa, Gd^Fp, Gd^Ve, Gd^Fdw, Hhd, Rr^Es, Rr, Gd^Esa, Aa, Hhd^Qhh, Wwrg, Gll^Qhh, Gd^Qhh, Hhd^Esa, Gll^Es, Gd^Fdw, Co^Edb, Co^Edb, Co, Gd^Fdw, Gll, Gll^Es, Gll, Gll^Es, Hhd, Hhd, Hhd, Gll^Feth
Ds, Ds, Ds, Md, Md, Gll, Gd^Fdw, Md, Gd^Fdw, Ds, Ds, Gd^Esd, Gll, Aa, Gd^Fp, Gd^Fdw, Gd^Esa, Hhd, Ds, Rr, Wwg, Wwf^Ewl, Wwg, Wwg, Hhd^Qhh, Hhd, Gll^Qhh, Gd^Fdw, Gll^Qhh, Gll^Qhh, Hhd^Qhh, Gd^Fdw, Gd^Vo, Gll, Md, Md, Hhd, Hhd^_mh, Hhd, Hhd
Gd, Ds, Hhd, Hhd, Gd, Gll, Gd^Fdw, Gd^Fp, Md, Gd, Gd^Qhu, Gd^Qhu, Gd^Qhu, Gll, Gd^Qhu, Gll^Qhu, Hhd^Em, Gll^Em, Ds, Wwg, Wwf^Ewl, Wwg, Wwf^Ewl, Wwf^Es, Wwf, Hhd^Qhh, Wwf, Gd^Qhh, Wwf, Wwf^Wkf, Hhd^Qhh, Hhd^Esa, Gd, Hhd^Esa, Md, Hhd^Fp, Hhd, Hhd, Hhd^Es, Gd
Gd^Fp, Hhd, Hhd^Fp, Hhd^Em, Hhd^Fp, Gd^Fdw, Md, Md, Md, Gd^Edb, Gll^Qhu, Gd^Qhu, Gd, Gll^Qhu, Gd^Fdw, Chr, Khr, Hhd, Ds^Edb, Wwrg, Wwrg, Wwf^Ewl, Wwrg, Wwrg, Wwf, Ds, Wwf^Es, Wwf^Ewl, Ds^Qhu, Wwg, Wwf^Es, Gd^Qhh, Hhd^Qhh, Gll, Hhd, Hhd, Gd^Fdw, Hhd^Fp, Gll^Fdw, Gd^Fdw
Hhd, Hhd, Md, Md, Md, Md, Md, Md, Md, Gll^Fdw, Gll^Emf, Gd, Gd, Gll^Em, Gd^Fdw, Chr, Ds, Chr, Ds, Wwf^Es, Wwg, Wwrg, Wwrg, Wwf^Wkf, Wwf^Qhu, Wwf, Wwrg^Qhu, Wwf^Qhu, Wwf^Qhu, Ds^Qhu, Ds^Qhu, Ds^Qhu, Hhd^Qhh, Hhd, Hhd, Hhd, Gll, Hhd, Gll^Es, Gd^Efm
Rr, Gd^Fp, Gd^Fdw, Hhd^Fp, Gd^Fp, Md, Md, Md^Xm, Gd^Fp, Gd^Fdw, Hhd^Fp, Hhd^Fp, Gd, Gll, Gll^Efm, Gd^Fdw, Ds^Edb, Wwg, Wwf, Wwf, Wwf, Wwf^Ewl, Wwf^Wkf, Wwg^Wkf, Wwf^Qhu, Wwf^Qhu, Wwf^Qhu, Re^Esa, Re^Esa, Hhd^Qhh, Hhd^Qhh, Hhd^Qhh, Hhd, Hhd, Hhd^Fp, Hhd^Es, Gd, Gll, Gd, Gd
Rr, Gd^Fdw, Gd^Fdw, Gd^Fdw, Md, Hhd^Em, Hhd^Fp, Md, Hhd, Hhd, Hhd, Md, Gd^Fdw, Gd^Edt, Re^Efm, Re, Wwf, Wwf, Wwf^Es, Wwf, Wwf, Wwg^Ewf, Wwg^Qhu, Ds^Qhu, Ds^Qhu, Gd^Fdw, Wwf^Qhu, Rb, Hhd^Qhh, Hhd^Qhh, Hhd, Hhd, Hhd, Hhd^Em, Hhd^Em, Hhd^Fp, Gd^Es, Gd^Edb, Gd, Gd
Gd^Fp, Gd^Fdw, Gd^Fp, Md, Gll^Fdw, Gll, Gll, Hhd, Gd^Em, Hhd^Em, Hhd^Em, Gd^Fdw, Gd, Gd^Edt, Aa, Wwrg, Wwf, Ds, Ds, Wwg, Wwf^Qhu, Wwg^Qhu, Rr^Es, Wwg^Qhu, Gll^Es, Rb, Aa^Feta, Aa, Aa, Ha^Qhh, Hhd, Hhd, Hhd^Esa, Hhd, Hhd^Em, Gll^Fdw, Hhd, Hhd, Gll^Fdw, Gll^Fdw
Gd^Fdw, Gll^Fdw, Gll^Fp, Gll^Fdw, Gd, Gd, Gll, Gd^Em, Md, Gd^Efm, Gll^Qhu, Gd^Ecf, Aa, Aa, Gd^Dr, Wwg, Wwg^Ewl, Wwf^Es, Ds, Wwg, Wwf^Qhu, Md, Rr^Es, Gd^Vh, Rb, Aa, Aa, Re, Gd^Esa, Hhd^Qhh, Hhd^Qhh, Hhd^Esa, Hhd, Hhd^Esa, Hhd^Esa, Hhd, Hhd, Hhd, Hhd, Hhd^Em
Gd, Gd^Fp, Gd^Ve, Gll^Fdw, Gd, Re^Esa, Re, Md, Md, Aa^Qhu, Chr^Esa, Gll^Edb, Gll^Edb, Gd, Gd^Edb, Ds, Wwg^Ewl, Wwg^Wkf, Ds, Wwf, Wwg, Rr^Es, Hhd, Gd, Gd^Efm, Aa, Re^Efm, Re^Esa, Gd, Gd^Esa, Hhd^Qhh, Hhd^Em, Hhd, Hhd^Em, Hhd, Md, Hhd, Hhd, Hhd, Hhd
Gd^Fp, Gd^Fp, Gd^Fp, Gd^Fp, Gd, Gll^Esa, Re^Em, Md, Md, Ch, 2 Kh, Chr, Re, Gd, Gd^Es, Gll^Fp, Wwg^Wkf, Wwf, Wwf^Ewl, Ds, Wwf^Qhu, Wwf^Qhu, Wwf^Qhu, Gll^Em, Rb, Aa, Re^Efm, Rb, Gd^Efm, Gd, Hhd^Qhh, Md^Qhh, Md^Qhh, Md^Qhh, Md^Qhh, Md^Xm, Md^Qhh, Md^Qhh, Md^Qhh, Md^Qhh
Gd, Rb, Rb, Rb, Gd^Em, Rb, Md, Md, Aa, Ch^Esa, Ch^Esa, Ch, Re, Gd, Gll^Es, Wwg^Wkf, Wwf^Es, Wwf, Ds^Qhu, Wwf^Qhu, Re, Wwf^Qhu, Gll^Em, Gd, Gll^Emf, Gd^Efm, Gd^Efm, Chr, Rb, Gll, Hhd^Qhh, Md^Qhh, Hhd, Md^Qhh, Md^Qhh, Md^Qhh, Md, Md^Xm, Md, Md
Gll, Gll, Gll, Gd^Efm, Rb, Rb, Md, Aa, Aa, Aa, Aa, Re, Gll, Gd, Re, Wwf, Ds^Qhu, Ds^Qhu, Re, Re, Wwrg^Qhu, Re, Gd, Re^Esa, Md, Gd^Em, Khr, Chr, Gd^Em, Gd, Gll, Hhd^Em, Hhd^Vhh, Hhd, Md, Md, Md, Md, Md^Xm, Md
Hhd, Md, Gd^Efm, Gd, Gll, Md, Aa^Esa, Aa, Gd^Vh, Rb, Gll^Es, Gll, Gll^Emf, Gd^Vh, Re, Rb^Efm, Wwf^Qhu, Wwrg^Qhu, Wwf^Qhu, Wwf^Qhu, Gd^Qhu, Hhd^Qhu, Re^Em, Re^Esa, Gd, Gd, Chr, Gll, Gll, Gll, Gll, Hhd^_ml, Hhd, Hhd, Md^Xm, Md, Md, Md^Xm, Md^Xm, Md^Xm
Hhd, Md, Md, Gd, Gd, Gd^Edt, Aa, Re^Em, Gd, Re, Gd^Qhu, Gll^Qhu, Gd^Qhu, Re, Gll, Re, Re, Wwf^Qhu, Re, Gd^Qhu, Re, Gd^Qhu, Wwrg^Qhu, Re^Em, Gd^Edt, Gd, Gd, Gd, Gd, Gll, Gll, Hhd, Md, Md, Md, Md, Hhd, Md, Md, Md
Md, Hhd^Em, Hhd^Esa, Gd, Aa, Aa, Aa, Re^Em, Gd^Esa, Chr, Chr, Khr, Chr, Re^Qhu, Gll^Em, Gll^Em, Gll^Em, Re, Gd, Re, Wwf^Qhu, Wwf^Qhu, Wwf^Qhu, Wwf^Qhu, Gd^Vhr, Gll^Feth, Gd^Edt, Aa, Gd, Gll^Efm, Gd^Edt, Hhd, Md, Md, Md, Md, Hhd^Em, Md, Hhd, Md
Md, Hhd^Em, Md, Hhd, Ha, Ha, Aa, Re, Re, Gd^Efm, Gd, Gd, Gd, Rb^Qhu, Re^Qhu, Gd^Efm, Gd, Gs, Rb^Es, Rb^Es, Rb^Qhu, Wwf^Qhu, Gll, Wwf^Qhu, Gll^Fdw, Rb, Md, Aa, Rb^Esa, Gd^Edt, Rb^Vhc, Hhd, Md, Md, Md^Xm, Md, Md, Hhd^Em, Md, Hhd
Md, Md^Xm, Md, Md, Ha, Hhd^Esa, Gll, Re, Gd, Gll^Em, Rb, Rb^Efm, Rb^Efm, Re, Aa, Re^Qhu, Aa^Esa, Ai, Wwf, Wwf^Qhu, Gll, Gd, Gll^Efm, Wwf^Qhu, Wwf^Qhu, Gll, Gd^Em, Md, Rb, Gd^Em, Rb^Efm, Md, Md, Md, Md^Xm, Md^Xm, Md^Xm, Hhd, Hhd^Em, Hhd
Md, Md, Md^Xm, Hhd, Ha^Esa, Hhd^Esa, Aa, Gd, Rb, Gd, Gd, Re, Wwf, Ai, Wwrg, Aa^Esa, Wwf^Es, Wwf^Es, Wwf^Qhu, Wwrg^Qhu, Wwf^Qhu, Gll, Gll, Gll, Gll, Gll^Efm, Chr, Gll, Rb, Gll^Em, Md, Gd^Fdw, Gd^Em, Md, Md, Md, Md, Hhd, Hhd, Md
Gd^Fp, Md, Md, Md, Gd, Aa, Gd, Gd, Gll, Rb, Rb^Efm, Wwf, Wwrg, Wwf, Wwrg, Wwrg, Wwrg, Wwf^Ewl, Wwrg^Qhu, Wwrg^Qhu, Wwf^Qhu, Gll, Gd, Gll, Rb^Efm, Gll, Gd, Rb, Chr^Efm, Chr, Ch, Rb^Efm, Gd, Md, Gll, Md, Md, Hhd, Hhd, Md
Gd^Fp, Gd^Fp, Gll^Em, Gd, Gd, Gd, Gd^Efm, Aa, Gd^Efm, Gll^Em, Gll^Em, Rb, Rb^Efm, Rb^Efm, Rb, Wwf^Ewl, Wwf^Ewl, Wwrg, Wwg^Wkf, Wwf^Qhu, Wwf^Qhu, Wwf^Qhu, Gd^Edt, Gll, Gd, Gll^Fdw, Gll, Gll^Efm, Chr^Efm, 3 Kh, Chr, Aa, Gd, Gd, Gd^Fdw, Gll, Hhd, Hhd, Rb, Rb
Wwrg, Gll^Ve, Gd^Fdw, Gd^Fdw, Ch, Ch, Ch^Es, Aa, Gll, Gd, Gll^Em, Hhd^Dr, Hhd^Dr, Hhd^Dr, Md, Rb, Rb^Efm, Wwg, Wwf^Wkf, Wwf, Wwf^Es, Aa^Qhu, Aa^Qhu, Gd^Edt, Gd, Gd, Gll, Rb, Gd, Ch^Es, Gd^Fdw, Rr^Vhc, Rb, Md, Gd^Fdw, Gll^Em, Gd^Qhu, Rb, Gll, Gll
Gd^Fp, Wwg, Gd^Fp, Gd^Fp, Chr^Edt, 1 Kh, Chr, Gll, Gd^Fdw, Gll, Rb, Hhd^Es, Md, Md^Xm, Md, Md, Md^Xm, Hhd, Wwf, Wwf, Aa, Ai^Esa, Aa^Qhu, Gd, Gd, Gd, Gd^Efm, Gll, Rr^Vhc, Rr, Gd^Efm, Gd^Fdw, Md, Rb, Gd^Qhu, Gll^Qhu, Gd^Qhu, Gd^Qhu, Gd^Qhu, Gd^Qhu
Wwg, Wwg^Wkf, Gll^Edt, Md, Md, Chr, Re^Es, Gd^Ecf, Gd, Rb, Gd^Efm, Hhd^Dr, Hhd, Md, Hhd, Md^Xm, Hhd, Hhd, Wwf^Es, Wwf^Es, Wwrg, Aa, Aa, Aa^Qhu, Wwf^Qhu, Gd^Esa, Gd^Fdw, Gd^Fdw, Gd^Fdw, Rr, Gd^Qhu, Gll^Qhu, Gll^Qhu, Rb^Qhu, Gll^Qhu, Hhd, Md, Gd^Qhu, Md, Md
Gll^Fdw, Wwg^Wkf, Gd^Ve, Md, Md, Md, Wwf, Re^Efm, Re^Efm, Re, Hhd^Em, Hhd^Emf, Hhd^Em, Hhd, Hhd, Wwrg, Wwf^Es, Wwf^Es, Wwf^Wkf, Wwrg, Wwf^Qhu, Wwf^Qhu, Wwf^Qhu, Wwf^Qhu, Rr^Qhu, Rr^Qhu, Rr^Qhu, Rr^Qhu, Rr^Qhu, Rr^Qhu, Md, Md, Hhd^Em, Hhd^Em, Hhd, Hhd, Md, Md, Md, Md
Gll^Fdw, Gll^Fdw, Gd^Fdw, Gd^Fetd, Gll^Fmw, Wwf, Wwg, Wwf, Wwg^Wkf, Re, Re, Hhd^Vhh, Gd^Fdw, Md, Wwrg, Wwrg, Wwf^Wkf, Wwf, Re, Re, Rr, Rr^Qhu, Rr^Qhu, Rr^Qhu, Gd, Gd, Hhd^Em, Hhd^Em, Gd^Fdw, Rr, Rr, Md, Rr, Rr, Rr, Md, Gd^Efm, Md, Md, Md
Gll^Fdw, Rb, Rb^Em, Rb, Gd, Wwrg, Gd^Em, Gll^Fp, Gd^Fdw, Wwg^Wkf, Wwrg, Hhd^Fp, Re, Gll^Fp, Gll^Em, Re^Emf, Re^Em, Re, Rr, Rr, Gll, Gll, Gd^Efm, Gll, Gll, Hhd, Hhd, Md, Md, Md, Md, Rr, Md, Hhd, Hhd^Em, Rr, Rr, Gd^Es, Hhd, Hhd
Gll^Fdw, Gll^Emf, Gd, Gd, Rb, Wwg, Gd, Gd^Em, Gll^Fp, Wwg^Wkf, Wwrg, Re, Gd, Gd, Gd, Gd, Gll^Es, Rr, Gd^Fdw, Gd^Fdw, Gd, Gd, Gll^Fdw, Gll^Fdw, Gd^Fp, Hhd, Hhd, Md, Md, Md, Md^Em, Hhd, Hhd^Em, Md, Md, Hhd, Md, Rr, Rr, Hhd
Wwf, Wwg, Md, Md, Md, Md, Md, Md, Wwf, Gll^Em, Gll^Em, Gll^Em, Gll, Gll, Rb, Gd, Re, Rr, Rr, Re^Qhu, Gll^Es, Gll^Es, Gll^Fdw, Gll^Fdw, Gll^Fdw, Gll^Fdw, Gll^Fdw, Hhd, Hhd^Qhh, Hhd^Em, Hhd, Hhd, Hhd^Qhh, Rb^Qhh, Md, Md, Rr, Rr, Gll, Gll^Efm
Wwf, Wwg, Wwf, Md, Md, Hhd, Wwf, Wwf, Hhd, Wwf, Wwf, Wwrg, Wwrg, Gd, Rb, Re, Gd^Fdw, Re, Re^Em, Rr, Rr, Md^Qhh, Md^Qhh, Gll^Fdw, Gd^Qhhf, Md^Qhh, Md^Qhh, Md^Qhh, Gll, Md^Qhh, Md^Qhh, Md^Qhh, Rb^_mh, Rb^Qhh, Rr, Rr, Rr, Gd^Efm, Hhd^Qhh, Hhd^Qhh
Hhd, Wwf, Md, Md, Md, Hhd, Hhd^Em, Hhd, Hhd, Hhd, Md, Wwf, Wwrg, Gll^Feth, Rb, Gll, Gll^Es, Re, Gd, Re^Em, Rr^Qhh, Hhd^Qhh, Md^Qhh, Gd^Qhhf, Rr, Rr, Rr, Gll, Ce, Ce, Ce, Gd^Efm, Rr, Rr^Qhh, Gll^Qhh, Gd, Hhd^Qhh, Hhd^Qhh, Hhd^Qhh, Md^Qhh
Hhd, Hhd, Md, Md, Wwf, Hhd^Emf, Hhd^Dr, Md, Md, Md, Gd^Fp, Md, Aa, Rb, Aa, Aa, Md^Qhh, Gll^Qhh, Re^Qhh, Re^Qhh, Rr, Rr, Rr, Rr, Gd^Efm, Gd, Gd, Rr, Ce, 5 Ke, Ce, Rr, Aa^Fdw, Gd, Rb, Gll^Qhh, Md^Qhh, Md^Xm, Hhd^Qhh, Hhd^Qhh
Hhd, Wwg^Wkf, Wwg^Wkf, Wwf, Wwrg, Wwf, Wwrg, Md, Aa, Aa, Gd, Aa, Md, Aa, Md, Md^Qhh, Md, Wwf, Wwf, Wwf, Rr, Gll, Gll, Gll^Efm, Wwf, Wwf, Wwf, Rb, Rb, Ce, Rr, Aa^Fdw, Gd^Fdw, Rb^Fdw, Rb, Hhd^Qhh, Md, Hhd^Qhh, Md, Md
Hhd, Md, Md, Md, Md, Wwrg, Md, Md, Gd, Aa, Gd, Gll^Em, Gll^Em, Md, Md, Md, Gd, Gll^Edb, Gll^Edb, Re^Esa, Rr, Md, Md, Md, Md, Md, Md, Wwf, Wwf, Gd, Aa, Aa^Feta, Gd, Gd^Fdw, Md^Qhh, Md^Qhh, Md, Md, Md, Md
