Ai, Ha^Esa, Ai^Esa, Ha^Esa, Md, Md, Md, Md, Gd^Esa, Md, Md^Qhh, Md^Qhh, Md^Qhh, Md^Qhh, Hhd, Hhd^Esa, Md, Md, Md, Aa, Gd, Gll^Fdw, Md, Md, Md, Md, Md, Md, Md^Xm, Md^Xm, Md^Xm, Md, Md, Md, Md, Md, Md, Md, Md, Md, Md, Md
Ha, Ai, Ha^Esa, Ha, Gd^Es, Md, Gd^Fdw, Gd^Esa, Gd^Esa, Md^Qhh, Md^Qhh, Md^Qhh, Hhd^Fp, Hhd, Md, Md, Md^Xm, Md^Xm, Md, Aa^Esa, Aa^Esa, Gll^Esa, Md, Md, Md, Md, Md, Md, Md, Md, Md, Md^Xm, Md^Xm, Md, Md^Xm, Md^Xm, Md, Md, Md, Md, Md, Md
Ha, Ha^Esa, Ha, Ha^Vhca, Md, Re^Efm, Gd^Fdw, Gd^Es, Aa^Fma, Md^Qhh, Md, Md^_mh, Md, Hhd^Fp, Hhd^Em, Md, Md, Md^Xm, Md, Md, Md^Xm, Md^Xm, Md^Xm, Md, Md, Md, Md, Md, Md, Md, Md, Md, Md, Md, Md, Md, Md, Md, Md^Xm, Md^Xm, Md, Md
Ha, Ha, Aa^Es, Md, Rr, Md, Md, Aa^Fmw, Aa^Fdw, Ha^Qhh, Ha^Vhca, Md^Xm, Md, Hhd^Fp, Md^Xm, Md^Xm, Md^Xm, Hhd^Emf, Md, Md, Md^Qhh, Md, Md^Qhh, Md, Hhd, Md, Md, Md, Md, Md, Md, Md, Md, Md, Md, Md^Xm, Md^Xm, Md^Xm, Md^Xm, Md, Md, Md
Ha, Aa, Aa^Fma, Ch, 2 Kha^Edb, Cha^Edb, Md, Aa^Fda, Aa^Fda, Ha^Qhh, Ha^Qhh, Md^Xm, Hhd^Qhh, Hhd^Es, Hhd^Qhh, Hhd^Emf, Md^Qhh, Hhd^Emf, Hhd^Qhh, Hhd^Qhh, Hhd^Qhh, Md^Qhh, Hhd^Qhh, Hhd^Qhh, Md^Xm, Md, Md, Md^Xm, Md, Md, Md, Md, Md, Md, Md, Md, Md, Md^Xm, Md, Md, Md, Md
Md^Qhh, Ai, Ha^Vhca, Cha, Cha, Cha^Edb, Hhd^Emf, Md, Md^Qhh, Aa^Fma, Re^Edb, Hhd^Qhh, Ai, Hhd^Qhh, Ai, Hhd^Qhh, Hhd, Hhd^Qhh, Gll^Qhh, Gll^Qhh, Hhd^Fp, Hhd^Qhh, Hhd^Qhh, Md^Qhh, Md^Qhh, Md^Qhh, Md^Xm, Md, Md, Md^Xm, Md, Md, Md, Md, Md, Md, Md, Md, Md, Md, Md, Md
Md^Qhh, Ai, Md, Hhd^Fp, Hhd^Edb, Hhd^Edb, Md^Qhh, Md^Qhh, Aa^Em, Aa^Fma, Gd^Em, Gll^Esa, Gll^Fdw, Ai, Hhd^Fp, Ai, Hhd^Fp, Hhd^Fp, Gd^Fetd, Gll^Esa, Rb, Hhd^Em, Gd^Esa, Hhd^Qhh, Hhd^Qhh, Md^Qhh, Md^Qhh, Md, Md, Md, Md, Md^Xm, Md, Md, Md, Md, Md^Qhh, Md, Md^_mh, Md, Md, Md
Md^Qhh, Ai^Esa, Ai^Esa, Md, Gll, Gd^Fdw, Gd^Edb, Aa, Gll^Fdw, Gd, Re^Edb, Gd^Edb, Gd, Gd^Fdw, Gll, Hhd^Fp, Gll^Fdw, Gd^Fdw, Gd^Fdw, Rb, Gd^Efm, Gll^Efm, Re^Em, Gll^Qhh, Hhd^Qhh, Gll^Qhh, Md^Qhh, Md, Md^Qhh, Md, Md, Md, Md, Md, Md^Qhh, Md^Qhh, Md, Md^Qhh, Md^Qhh, Md^Qhh, Md^Qhh, Md
Md^Qhh, Md^Qhh, Hhd^Em, Gll, Hhd^Fp, Gd^Edb, Md^Qhh, Gd, Md^Qhh, Gd, Gll^Efm, Re^Edb, Hhd^Fp, Gll^Fdw, Md^Qhh, Gd, Md^Qhh, Gd^Edb, Md^Qhh, Rb, Md^Qhh, Re^Em, Hhd^Fp, Gd^Em, Hhd^Qhh, Hhd^Qhh, Md^Qhh, Md^Qhh, Gll^Qhh, Md^Qhh, Md, Md, Md, Md, Wwrg, Wog, Gll^Fdw, Gll^Fdw, Wwf^Qhu, Wwf^Qhu, Md^Qhh, Md^Qhh
Md^Xm, Md^Qhh, Hhd^Qhh, Gd^Qhh, Md^Qhh, Gll^Efm, Md^Qhh, Md^Qhh, Md^Qhh, Gll^Efm, Hhd^Fp, Hhd^Fp, Gll^Efm, Gll^Efm, Md^Qhh, Md^Qhh, Md^Qhh, Hhd^Qhh, Md^Xm, Md^Qhh, Md, Md^Qhh, Re^Em, Re^Em, Re^Em, Hhd^Fp, Hhd^Qhh, Gll^Qhh, Rb^Es, Md^Qhh, Md^Qhh, Md^Qhh, Md^Qhh, Md^Qhh, Wwrg, Wog, Gll^Fdw, Wwf^Qhu, Gll^Fdf, Md^Qhh, Md^Qhh, Md^Qhh
Md, Md, Hhd^Qhh, Re^Qhh, Md^Qhh, Hhd^Qhh, Hhd^Qhh, Md^Qhh, Hhd^Qhh, Hhd^Qhh, Gd^Qhh, Gd^Es, Gd^Qhh, Gll, Md^Qhh, Md, Md, Md^_mh, Md, Md, Md, Hhd^Emf, Gll^Efm, Gll^Edb, Gd^Esa, Gll^Edb, Gll^Efm, Gd^Ve, Gll^Efm, Md^Qhh, Gll^Efm, Wwg, Rb^Es, Rb, Gll^Fdw, Gll^Fdw, Wwg^Qhu, Wwf^Qhu, Gll, Gd, Md^Qhh, Md^Qhh
Hhd, Hhd^Dr, Md, Md, Md^Qhh, Md^Qhh, Hhd, Hhd^Fp, Gd^Fetd, Hhd^Qhh, Hhd^Qhh, Hhd^Qhh, Md^Qhh, Gd^Edb, Gd^Vhr, Md^Qhh, Md, Md, Md, Md, Md, Hhd^Qhh, Hhd^Em, Hhd^Em, Gd^Fetd, Gd^Esa, Cvr, Cha^Edb, Cha^Edb, Hhd^Dr, Gll^Fdw, Rb, Gll^Fdf, Gll^Fdw, Gll^Fdf, Re, Rb, Wwf^Qhu, Wog, Gll^Es, Md^Qhh, Md^Qhh
Gll, Md, Md, Md, Md, Md, Hhd^Fp, Hhd^Fp, Gll, Gll^Efm, Hhd^Em, Md, Md^Qhh, Gll, Rb^Edb, Md^Qhh, Md^Qhh, Md, Md, Md, Md, Md, Md, Hhd^Fp, Hhd^Fp, Gd, Cvr, 4 Kha^Edb, Cha^Edb, Gll^Fdf, Gll^Fdf, Gd, Gd^Efm, Gll^Fdf, Gll, Re^Es, Wog^Qhu, Wog^Qhu, Gll^Efm, Gll, Rb^Edt, Gd^Efm
Gll, Gll^Emf, Gll, Md, Md, Md, Md, Gd^Edb, Hhd, Hhd^Em, Hhd^Em, Md^Xm, Md, Rb^Qhh, Gll^Efm, Gd^Qhh, Md^Qhh, Md^Qhh, Md, Md, Md^Xm, Md, Gll^Efm, Gll^Efm, Md, Gd, Gll^Fdw, Cvr, Re^Edb, Md, Hhd^Fdf, Gll^Fdf, Gd^Efm, Gd^Efm, Gll, Gll, Wwf^Qhu, Wwrg, Rb, Rb, Gd, Gd^Efm
Wwg, Md, Wwg, Gd^Edb, Gll^Fdw, Gll^Fdw, Re^Efm, Md, Gll, Gll^Edb, Gll, Gll^Dr, Md, Rb^Qhh, Gll, Gll^Edb, Md, Md^Qhh, Md^Qhh, Md^Xm, Md, Md, Gll, Gd^Efm, Gd^Efm, Gd^Efm, Gd^Edb, Gd^Edb, Gd^Edb, Re^Edb, Gd^Ve, Hhd, Gd^Efm, Gll^Fdw, Gll^Fdw, Re^Es, Wog^Qhu, Gll, Gll, Gll^Fdf, Gll^Fdf, Gd
Wwrg, Wwg, Wwg^Wkf, Wwf, Wwf^Es, Gll^Fmw, Gll^Fmw, Re, Rb, Rb^Edb, Gll^Edb, Wwf^Wkf, Md, Md, Md, Gd^Edb, Rb, Gd, Hhd^Efm, Md^Xm, Hhd, Gd^Vhr, Hhd^Efm, Gd^Em, Gd^Em, Gd, Md, Gd, Hhd^Em, Hhd, Gll, Gd^Efm, Gll^Es, Gll^Fdw, Gll, Wwg^Qhu, Wog, Gll^Fdw, Wog, Md, Gll^Es, Gd
Wwf, Wwf^Es, Wwf^Es, Wwf, Wwf, Wwrg, Wog, Rb^Edb, Wwg, Gll^Es, Wwf^Wkf, Wwf^Wkf, Md, Md, Md, Rb^Es, Rb, Hhd^Em, Hhd, Hhd^Fp, Gd, Hhd, Gd^Edb, Gd^Dr, Gll, Md, Gd, Gd, Gd, Gll^Efm, Wwf^Qhu, Gll^Es, Wwf^Qhu, Gll, Wog^Qhu, Wwg^Qhu, Wwf, Wog, Wwg, Gll^Es, Gll, Gd^Em
Wwg, Wwg, Wog, Wog, Wwf^Es, Wwg^Ewf, Wwg, Wog, Wwf^Es, Wwg^Wkf, Wwg^Ewl, Wwrg, Wwrg, Wwrg, Gll, Md, Rb^Es, Gd^Edb, Gd, Gd, Gd, Gd, Gd, Gll, Gd^Efm, Hhd, Gll, Gd^Efm, Gd, Gll, Wwf^Qhu, Wwf^Qhu, Ww^Qhu, Wwf^Qhu, Wog, Wwf, Wwf, Gll^Es, Wwf^Es, Rb^Em, Gd^Emf, Gll
Gll, Gll^Em, Rb, Wwf, Wwf^Ewl, Wwg^Ewl, Wwg^Es, Wwg^Es, Wwf, Wwf^Ewl, Wog, Wog, Md, Wog, Wog, Gll^Es, Wwg^Ewl, Gd^Edb, Gll^Fp, Md, Md, Gd^Efm, Gd^Efm, Gll^Efm, Gd^Edb, Gd^Vhr, Gd^Em, Hhd^Em, Hhd^Emf, Gll^Es, Wwf^Qhu, Wog^Qhu, Gll^Es, Wwf, Gll^Es, Wog^_ml, Wwrg, Rb^Em, Gd, Gll^Edb, Gd, Gll
Hhd^Fdw, Gll^Fdw, Gll^Fdw, Rb, Rb^Efm, Gll^Efm, Gll, Gll^Fdw, Wwf^Es, Md, Wwf, Gll^Es, Md, Wwg^Es, Wwg, Wwf^Es, Wwf, Gll^Fdf, Gll^Fdf, Md, Md, Md, Md, Gll^Fdw, Gd^Edt, Gll, Gll^Esd, Hhd, Wog^Qhu, Wwf^Qhu, Wog^Qhu, Wog^Qhu, Gll, Gd^Es, Md, Md, Gll, Gll, Gll^Efm, Hhd^Qhh, Md^Qhh, Gd
Md^Qhh, Hhd^Fdw, Md^Qhh, Gll^Qhh, Re^Emf, Re^Vct, Re^Em, Gd^Edb, Gd^Em, Gd^Esd, Gll^Fdw, Gd^Em, Gll^Fdw, Wwg^Ewl, Wwf, Wwf, Wwf^Wkf, Wwf^Ewl, Md, Md, Md, Gll^Edb, Hhd^Fdf, Hhd^Fdw, Gll, Wwf^Qhu, Wwf^Qhu, Wwrg^Qhu, Wwg^Qhu, Wwf^Qhu, Wwg, Wwrg, Gd^Edb, Gll^Fdw, Gd^Emf, Hhd^Qhh, Hhd^Qhh, Hhd^Qhh, Hhd^Qhh, Hhd^Qhh, Md^Xm, Gll^Qhh
Hhd, Md^Qhh, Md^Qhh, Gll^Fdw, Re^Em, Wwf^Qhu, Wwf^Qhu, Re^Edb, Hhd^Edb, Hhd^Edb, Md, Gd, Gll^Fdw, Wwg^Ewl, Rb^Dr, Wwf^Wkf, Gll^Fmw, Md, Md, Md, Md, Gll^Edt, Gll, Gd, Wwf^Qhu, Gll^Esa, Wwg^Qhu, Wwg^Qhu, Wwf^Ewl, Wwf, Wwrg, Wwrg, Gd^Efm, Gd^Es, Gd^Es, Gd^Efm, Md^Qhh, Hhd^Fp, Md^Xm, Md^Xm, Md^Xm, Md
Hhd^Fp, Hhd^Em, Hhd^Emf, Hhd^Qhh, Hhd^Em, Hhd^Fetd, Wwf^Qhu, Wwg^Qhu, Wwf^Qhu, Wwf^Ewl, Md, Gll^Efm, Gll^Efm, Gll^Fdw, Gll^Es, Rb, Gd, Md, Gd^Efm, Md, Hhd^Vhhr, Md, Gll, Wwrg^Qhu, Wwf^Qhu, Wwg^Qhu, Wwg^Es, Wwrg, Wwf^Es, Wwf^Wkf, Wwf^Wkf, Gll, Gd, Hhd^Qhh, Md^Qhh, Md^Qhh, Md^Xm, Md^Xm, Md, Md^Xm, Md, Md
Wwg, Hhd^Fp, Hhd, Md^Qhh, Md^Qhh, Wwf, Wog^Qhu, Wwg^Qhu, Wwg^Qhu, Wwrg^Qhu, Gll^Em, Gll^Efm, Gll^Fdf, Gll^Fdf, Gll^Fdf, Wwf, Gll^Fdf, Gd^Efm, Wwf, Gd^Efm, Gll^Efm, Gll^Edb, Wwg^Qhu, Wwf^Qhu, Wwg^Ewl, Rb^Es, Gll, Wwf, Rb^Efm, Wwg, Gll, Gll^Efm, Gll, Hhd^Qhh, Md, Md, Md, Md, Md, Md, Md, Md
Gd^Fp, Hhd^Fp, Hhd^Fp, Md^Qhh, Hhd^Fp, Md, Wwf, Wwg^Qhu, Wwf^Qhu, Wwg^Qhu, Gd^Edb, Wwrg, Gll^Efm, Gd^Es, Wwf, Gll, Gll^Fdf, Gll^Fdf, Gll^Fdf, Gll^Fdf, Gll^Efm, Wwf^Qhu, Wwf^Qhu, Wwg^Ewf, Wwg^Wkf, Wwg^Wkf, Re^Em, Re^Vct, Gd^Efm, Gd, Md^Qhh, Md^Qhh, Md^Qhh, Md^Qhh, Md, Md, Md^Xm, Md, Hhd^_mh, Md, Md, Md
Gll^Fp, Gll^Fmw, Gd^Fp, Hhd^Fp, Gd^Fp, Gll^Emf, Gll, Gll^Edb, Wwf^Qhu, Wwg^Qhu, Gd^Fp, Gll, Gll, Gll^Fdf, Wwf^Ewf, Gll^Es, Gll^Fdf, Re, Gll^Es, Gd, Gd^Efm, Re^Edb, Gll^Es, Wwf^Qhu, Wwrg, Wog, Gll^Esa, Gd^Efm, Hhd^Qhh, Md^Qhh, Md, Md^Xm, Md, Md, Md, Md^Xm, Md, Md, Md^Xm, Hhd^Es, Md^Xm, Md^Xm
Wwg^Qhu, Gll^Fp, Wog^Qhu, Wwrg^Qhu, Wwg^Qhu, Gll^Fmw, Wwg^Qhu, Wwg^Qhu, Wwf^Qhu, Wwf^Qhu, Wwf^Qhu, Wwg^Qhu, Gll^Es, Gll, Wwf^Qhu, Wwf^Qhu, Gd^Efm, Gd^Es, Wog^Qhu, Wwf^Qhu, Wwf^Qhu, Rb, Gll, Wwrg^Qhu, Wog, Wog, Gll, Hhd, Hhd^Qhh, Md, Hhd^Fp, Md, Hhd^Emf, Hhd^Edb, Hhd^Edb, Md^Xm, Md^Xm, Md, Md, Hhd^Fp, Md, Md^Xm
Wwg^Qhu, Wwg^Qhu, Wwg^Qhu, Wwg^Qhu, Wwg^Qhu, Wwg^Qhu, Wwg^Qhu, Wwg^Qhu, Gll, Gll^Em, Wwf^Qhu, Wwg^Qhu, Wwg^Qhu, Wwf^Qhu, Wwf^Qhu, Gd^Efm, Gll, Wog^Qhu, Wwf^Qhu, Wwg^_ml, Wwf^Qhu, Gll^Es, Wwg^Qhu, Wwrg^Qhu, Gll^Qhu, Gll^Efm, Rb^Edb, Hhd, Md^Qhh, Hhd^Esa, Hhd^Esa, Hhd^Em, Md, Md, Md^Qhh, Hhd^Qhh, Md^Qhh, Md, Md, Md, Md, Md
Gll^Fp, Wwg^Qhu, Gll^Fp, Gll^Em, Gll^Efm, Wwf^Qhu, Gd^Fp, Rb, Rb, Rb^Emf, Gll^Edb, Wwg^Es, Gll^Edb, Wog, Wwf, Wwf^Qhu, Wwf^Qhu, Wwf^Qhu, Wwg^Qhu, Wwf^Qhu, Gll^Efm, Wwf^Qhu, Gll^Emf, Wwg, Gll^Qhu, Wwg^Qhu, Wwf^Qhu, Rb^Edb, Wwrg^Qhu, Md^Qhh, Md^Qhh, Md, Md^Qhh, Md^Qhh, Gll^Es, Hhd^Vhhr, Md^Qhh, Md, Md, Md, Hhd^Fp, Md
Gd^Fp, Gll^Fp, Gll^Fdw, Gd^Fp, Cvr, Gd^Fp, Gd^Fetd, Gd^Fp, Gll^Fdf, Gll^Edb, Gd^Fp, Gd, Gll^Efm, Wwrg, Rb^Es, Wwf^Wkf, Gll^Es, Rb^Es, Wwg^Qhu, Gll^Efm, Wwf, Rb, Rb^Es, Wwg, Gd^Fdw, Gll^Qhu, Gll^Qhu, Wwf^Qhu, Wwf^Qhu, Wwf^Qhu, Wwf^Qhu, Md^Qhh, Md^Qhh, Gd^Es, Gll, Md^Qhh, Gd, Hhd^Qhh, Md, Md^Xm, Md, Md
Gll^Em, Gd^Ve, Gll^Fp, Cvr, 3 Kvr, Cvr, Gd^Fp, Gd^Dr, Gll^Ve, Gll^Fmw, Gll^Fdw, Gd^Fp, Wwrg, Rb, Gll^Fdw, Rb, Gd^Esa, Gd^Es, Wwrg^Qhu, Gll, Gll, Gd^Fdw, Rb^Efm, Rb^Es, Gd^Emf, Gd^Emf, Wwf^Qhu, Wwf^Qhu, Gll^Es, Wwf^Qhu, Gll, Gll^Qhu, Gd, Gd, Gll^Edb, Md, Gd^Es, Hhd^Qhh, Hhd^Edb, Hhd^Edb, Md, Md
Gll^Fp, Gll^Fdw, Gd^Fp, Cvr, Cvr, Cvr, Gll^Fp, Gll^Fdw, Wog, Wwf, Gll^Fdw, Wwrg, Gll^Fp, Gd^Fp, Gd^Fp, Gd^Em, Gll, Wwf^Qhu, Gll^Es, Wwrg^Qhu, Rb, Gd^Efm, Aa^Esa, Gd, Gd^Ve, Gll^Edb, Gll^Edb, Gd^Esa, Re, Gll^Esa, Rb, Hhd, Md, Md, Hhd, Gll, Hhd, Hhd^Qhh, Hhd^Qhh, Hhd^Qhh, Hhd^Qhh, Md
Gll^Fp, Gll^Fdw, Gll^Fmw, Gd^Fp, Gll^Fdf, Gll^Fp, Wwf^Wkf, Wwf^Wkf, Gll^Fp, Wog, Wwg^Es, Wwrg, Gll^Fdw, Gd^Fp, Wwf, Gll^Emf, Rb, Rb, Gll^Dr, Wwrg^Qhu, Wwg^Qhu, Gll, Aa, Aa^Efm, Ai^Esa, Ai, Gd^Efm, Gd^Esa, Gd^Esa, Re, Re^Em, Rb, Rb, Md, Gll, Gll, Gll^Esa, Gd, Gd^Qhu, Gll^Qhu, Hhd, Hhd^Qhh
Md, Gll^Fdf, Md, Rb^Efm, Rb^Efm, Gll^Fdf, Md, Md, Gd^Fp, Rb^Efm, Rb^Efm, Gll^Fp, Gd^Fp, Gll^Fp, Wwg, Gll^Em, Wwf, Gd^Vhr, Gll^Es, Wwrg^Qhu, Gll^Fdw, Gll^Esa, Aa, Md, Md^Qhh, Ai^Esa, Hhd^Qhh, Gll^Em, Md^Qhh, Gll^Emf, Rb, Gll, Gd^_ml, Hhd, Gd^Efm, Gd^Efm, Gd^Qhu, Gd^Qhu, Ha, Gll^Qhu, Gd^Qhu, Gd^Qhu
Md, Md, Md^Em, Gd^Fp, Rb, Gll^Fdf, Gd^Fp, Gd^Fetd, Gd, Gll^Dr, Gd^Esa, Gd^Fp, Wwrg, Wog, Gll^Em, Gll^Efm, Gd, Gd, Rb^Efm, Gll^Es, Gll^Esa, Gd, Aa^Esa, Md^Qhh, Md^Xm, Md^Qhh, Md, Hhd^Qhh, Hhd, Md^Qhh, Md^Qhh, Gll^Es, Gll^Qhu, Gd^Esa, Gd^Qhu, Re^Qhu, Re^Qhu, Gd^Qhu, Ha, Ai^Esa, Ai, Ai
Gll^Fp, Wwf^Es, Wog, Gd^Fp, Wwrg, Gll^Esd, Gll^Efm, Gd, Gd, Gd, Gd, Gd^Fp, Gll^Efm, Gll^Efm, Gd, Gd, Re^Em, Re, Re, Rb^Efm, Gll, Aa^Esa, Md^Qhh, Md^Qhh, Md^Xm, Md^Xm, Md, Md, Hhd^Qhhf, Hhd^Fp, Md, Md^Qhh, Md^Qhh, Gd^Qhu, Gd^Es, Gd^Fdw, Re^Efm, Gll^Efm, Ha^Vhca, Ha^Esa, Ha^Esa, Ha
Gll, Gd^Fp, Gll^Fdw, Wwrg, Gll^Fp, Rb, Gll^Efm, Wwrg, Gll^Fdf, Gll^Fdw, Gll^Fmw, Gll, Re, Gll^Efm, Md, Rb, Gll^Efm, Gll^Efm, Re^Em, Rb^Esd, Md, Md^Qhh, Md, Md, Hhd^Emf, Md, Md^_mh, Hhd^Em, Hhd^Fp, Md, Md^Xm, Md, Ha^Qhh, Aa^Fma, Aa^Fmw, Gd^Fdw, Aa^_ml, Ha, Ha, Ha^Esa, Ha, Ha
Md, Gll^Fdw, Md, Gd^Fp, Wwf, Gll^Fdw, Gd^Efm, Re, Gll, Wwg^Ewl, Re^Es, Re, Wwg^Es, Re, Md, Rb, Gll^Efm, Hhd^Qhh, Hhd^Qhh, Re, Gd^Ve, Md^Qhh, Hhd^Qhh, Md, Hhd^Emf, Md^Xm, Hhd^Emf, Md^Xm, Hhd^Es, Md, Md^Xm, Ha^Vhca, Ha^Qhh, Aa^Fdw, Aa^Fda, Gd^Ecf, Cea^Edb, Cea^Edb, Cea, Aa, Aa^Es, Ha
Md, Md^Xm, Md, Hhd, Gd^Fetd, Gll^Fdf, Gd, Rb, Gll^Es, Wwg, Wog, Wwg, Wwg, Md, Wwf^Wkf, Md, Md^Qhh, Md^Qhh, Md^Qhh, Hhd^Qhh, Hhd, Hhd, Gll, Hhd^Qhh, Hhd^Qhh, Md, Hhd^Qhh, Hhd^Qhh, Hhd^Qhhf, Hhd^Qhh, Hhd^Qhh, Ha^Qhh, Aa^Fma, Md, Md, Md, Cea, 1 Kea, Cea, Aa^Fma, Ai^Esa, Ha
Hhd, Md, Hhd^Em, Hhd, Re^Edb, Re^Edb, Rb^Emf, Rb, Wwf, Gll^Efm, Gll, Wog^Ewf, Wog, Wwf, Wwg, Md, Md^Qhh, Md^_mh, Hhd^Qhh, Hhd^Qhh, Hhd, Hhd, Gll^Esa, Gll, Aa^Fmw, Hhd^Qhh, Ai, Ai, Ai, Ai, Gll^Esa, Re^Edb, Aa^Fma, Md, Md, Hhd^Emf, Hhd, Cea, Hhd^Fp, Ha^Vhca, Ai^Esa, Md
Hhd^Fp, Hhd^Emf, Hhd^Fp, Gll^Fdw, Gll, Gll^Em, Gll^Em, Wwf, Wwg^Ewl, Gll^Efm, Wog, Gll^Es, Wwf, Wwrg, Re^Em, Gll^Es, Gll^Fdw, Hhd^Qhh, Gll, Gll, Gll^Efm, Rb, Rb, Gd^Fetd, Gd^Fdw, Aa^Fmw, Aa^Fmw, Aa^Em, Gd^Fdw, Gll^Fdw, Ai, Gd^Em, Gd^Em, Aa^Em, Aa, Md, Gd^Fdw, Hhd, Md, Md, Ai, Md
Hhd^Fp, Md, Gll^Fp, Gd, Gll, Wwrg, Wwg, Wwg, Wwg, Wwg^Ewl, Wwg, Gll^Efm, Gll^Efm, Gd, Gd, Re, Gll, Gll, Gll, Gd, Gd, Gd^Efm, Rb, Gd^Fdw, Gd^Edb, Gll^Fdw, Gd, Gll, Gll^Fdw, Gd, Gll, Gll, Gll, Gll^Fdw, Gd, Gd, Gd, Ai, Ai, Ai, Md, Md
