Ai, Ha^Esa, Ai^Esa, Ha^Esa, Md, Md, Md, Md, Gd^Esa, Md, Gll^Es, Md, Md, Md, Hhd, Hhd^Esa, Md, Md, Md, Aa, Gd, Gll^Fdw, Md, Md, Md, Md, Md, Md, Md^Xm, Md^Xm, Md, Md, Md, Md, Md, Md, Md, Md, Md, Md, Md, Md
Ha, Ai, Ha^Esa, Ha, Gll^Efm, Md, Gd^Fdw, Gd^Esa, Gd^Esa, Gll^Es, Md, Md, Hhd^Fp, Hhd, Md, Md, Md^Xm, Md^Xm, Md, Aa^Esa, Aa^Esa, Gll^Esa, Md, Md, Md, Md, Md, Md, Md, Md, Md, Md, Md, Md, Md^Xm, Md^Xm, Md, Md, Md, Md, Md, Md
Ha, Ha^Esa, Ha^Esa, Ha^Vhca, Md, Re^Efm, Gd^Fdw, Gd^Es, Aa^Fma, Md, Md, Md, Md, Hhd^Fp, Hhd^Em, Md, Md, Md^Xm, Md, Md, Md^Xm, Md, Md, Md, Md, Md, Md, Md, Md, Md, Md, Md, Md, Md, Md, Md, Md, Md, Md^Xm, Md^Xm, Md, Md
Ha, Ha, Aa^Es, Md, Rr, Aa, Md, Aa^Fmw, Aa^Fdw, Ha^Es, Ha^Vhca, Md^Xm, Md, Hhd^Fp, Md^Xm, Md^Xm, Md^Xm, Hhd^Emf, Md, Md, Md, Md, Md, Md, Hhd, Md, Md, Md, Md, Md, Md, Md, Md, Md, Md, Md^Xm, Md^Xm, Md^Xm, Md^Xm, Md, Md, Md
Ha, Aa^Es, Aa^Fma, Ch, 2 Kha^Edb, Cha^Edb, Md, Aa^Fda, Aa^Fda, Ha^Es, Ha^Esa, Md^Xm, Hhd^Fp, Hhd^Es, Hhd^Es, Hhd^Emf, Md, Hhd^Emf, Hhd^Esa, Hhd^Fp, Hhd^Fp, Md, Hhd^Edb, Hhd^Fmw, Md, Md, Md, Md, Md, Md, Md, Md, Md, Md, Md, Md, Md, Md^Xm, Md, Md, Md, Md
Md^Em, Ai^Esa, Ha^Vhca, Cha, Cha, Cha^Edb, Hhd^Emf, Md, Md, Aa^Fma, Re^Edb, Hhd^Edb, Ai, Hhd^Fp, Ai, Hhd^Em, Hhd, Hhd^Esa, Gll^Edb, Gll^Edb, Hhd^Fp, Hhd^Em, Hhd, Md, Md, Md, Md^Xm, Md, Md, Md^Xm, Md, Md, Md, Md, Md, Md, Md, Md, Md, Md, Md, Md
Md^Em, Ai^Esa, Md, Hhd^Fp, Hhd^Edb, Hhd^Edb, Md, Md, Aa^Em, Aa^Fma, Gd^Em, Gll^Esa, Gll^Fdw, Ai, Hhd^Fp, Ai, Hhd^Fp, Hhd^Fp, Gd^Fetd, Gll^Esa, Rb, Hhd^Em, Gd^Esa, Hhd^Edb, Hhd^Fmw, Md, Md, Md, Md, Md, Md, Md, Md, Md, Md, Md, Md, Md, Md, Md, Md, Md
Md, Ai^Esa, Ai^Esa, Md, Gll^Edb, Gd^Fdw, Gd^Edb, Aa, Gll^Fdw, Gll^Em, Re^Edb, Gd^Edb, Gd, Gd^Fdw, Gll, Hhd^Fp, Gll^Fdw, Gd^Fdw, Gd^Fdw, Rb, Gd^Efm, Gll^Efm, Re^Em, Gll^Edb, Hhd^Es, Gll^Fdw, Md, Md, Md, Md, Md, Md, Md, Md, Md, Md, Md, Md, Md, Md, Md, Md
Md^Xm, Md, Hhd^Em, Gll, Hhd^Fp, Gd^Edb, Md, Gd, Md, Gd, Gll^Efm, Re^Edb, Hhd^Fp, Gll^Fdw, Md, Gd, Md^Xm, Gd^Edb, Md, Rb, Md, Re^Em, Hhd^Fp, Gd^Em, Hhd^Fp, Hhd^Fp, Md, Md, Gll^Efm, Md, Md, Md, Md, Md, Wwrg, Wog, Gll^Fdw, Gll^Fdw, Wwf, Wwf, Md, Md
Md^Xm, Md, Hhd^Em, Gd^Edb, Md, Gll^Efm, Md, Md, Md^Es, Gll^Efm, Hhd^Fp, Hhd^Fp, Gll^Efm, Gll^Efm, Md, Md^Xm, Md^Xm, Hhd^Fp, Md^Xm, Md, Md, Md, Re^Em, Re^Em, Re^Em, Hhd^Fp, Hhd, Gll^Es, Rb^Es, Md, Md, Md, Md, Md, Wwrg, Wog, Gll^Fdw, Wwf, Gll^Fdf, Md, Md, Md
Md, Md, Hhd^Fp, Re^Edb, Md, Hhd^Emf, Hhd^Em, Md, Hhd, Hhd^Es, Gd^Es, Gd^Es, Gd^Esd, Gd^Edb, Md, Md, Md, Md, Md, Md, Md, Hhd^Emf, Gll^Efm, Gll^Edb, Gd^Esa, Gll^Edb, Gll^Efm, Gd^Ve, Gll^Efm, Md, Gll^Efm, Wwg, Rb^Es, Rb^Es, Gll^Fdw, Gll^Fdw, Wwg, Wwf, Gll^Es, Gd, Md, Md
Hhd, Hhd^Dr, Md, Md, Md, Md, Hhd, Hhd^Fp, Gd^Fetd, Hhd, Hhd^Em, Hhd^Em, Md^Xm, Gd^Edb, Gd^Vhr, Md, Md, Md, Md, Md, Md, Hhd^Em, Hhd^Em, Hhd^Em, Gd^Fetd, Gd^Esa, Cvr, Cha^Edb, Cha^Edb, Hhd^Dr, Gll^Fdw, Rb, Gll^Fdf, Gll^Fdw, Gll^Fdf, Re, Re^Es, Wwf, Wog, Gll^Es, Md, Md
Gll, Md, Md, Md, Md, Md, Hhd^Fp, Hhd^Fp, Gll^Efm, Gll^Efm, Hhd^Em, Md, Md^Xm, Gll, Rb^Edb, Md, Md, Md, Md, Md, Md, Md, Md, Hhd^Fp, Hhd^Fp, Gd, Cvr, 4 Kha^Edb, Cha^Edb, Gll^Fdf, Gll^Fdf, Gd, Gd^Efm, Gll^Fdf, Gll, Re^Es, Wog, Wog, Gll^Efm, Gll, Rb^Edt, Gd^Efm
Gll, Gll^Emf, Gll, Md, Md, Md, Md, Gd^Edb, Hhd, Hhd^Em, Hhd^Em, Md^Xm, Md, Rb, Gll^Efm, Gd, Md, Md, Md, Md, Md^Xm, Md, Gll^Efm, Gll^Efm, Md, Gd, Gll^Fdw, Cvr, Re^Edb, Md, Hhd^Fdf, Gll^Fdf, Gd^Efm, Gd^Efm, Gll, Gll, Wwf, Wwrg, Rb, Rb^Edt, Gd^Efm, Gd^Efm
Wwg, Md, Wwg, Gd^Edb, Gll^Fdw, Gll^Fdw, Re^Efm, Md, Gd^Edb, Gll^Edb, Gll, Gll^Dr, Md, Rb, Gll, Gll^Edb, Md, Md, Md, Md^Xm, Md, Md, Gll, Gd^Efm, Gd^Efm, Gd^Efm, Gd^Edb, Gd^Edb, Gd^Edb, Re^Edb, Gd^Ve, Hhd, Gd^Efm, Gll^Fdw, Gll^Fdw, Re^Es, Wog, Gll^Edb, Gll, Gll^Fdf, Gll^Fdf, Gd
Wwrg, Wwg, Wwg^Wkf, Wwf, Wwf^Es, Gll^Fmw, Gll^Fmw, Re, Rb, Rb^Edb, Gll^Edb, Wwf^Wkf, Md, Md, Md, Gd^Edb, Re^Vct, Gd^Edb, Hhd^Efm, Md^Xm, Hhd, Gd^Vhr, Hhd^Efm, Gd^Em, Gd^Em, Gd, Md, Gd, Hhd^Em, Hhd, Gll, Gd^Efm, Gll^Es, Gll^Fdw, Gll^Es, Wwg, Wog, Gll^Fdw, Wog, Md, Gll^Es, Gd
Wwf, Wwf^Es, Wwf^Es, Wwf, Wwf, Wwrg, Wog, Rb^Edb, Wwg, Gll^Es, Wwf^Wkf, Wwf^Wkf, Md, Md, Md, Rb^Esd, Rb, Hhd^Em, Hhd, Hhd^Fp, Gd^Edb, Hhd, Gd^Edb, Gd^Dr, Gll, Md, Gd, Gd, Gd, Gll^Efm, Wwf, Gll^Es, Wwf^Wkf, Gll^Es, Wog, Wwg^Es, Wwf, Wog, Wwg, Gll^Es, Gd^Edb, Gd^Em
Wwg, Wwg, Wog, Wog, Wwf^Es, Wwg^Ewf, Wwg, Wog, Wwf^Es, Wwg^Wkf, Wwg^Ewl, Wwrg, Wwrg, Wwrg, Gll, Md, Rb^Es, Gd^Edb, Gll^Edb, Gd^Edb, Gd, Gd^Edb, Gd, Gll, Gd^Efm, Hhd, Gll, Gd^Efm, Gd, Gll, Wwf, Wwf^Wkf, Ww^Ewf, Wwf^Wkf, Wog, Wwf, Wwf, Gll^Es, Wwf^Es, Rb^Edb, Gd^Emf, Gd^Em
Gll, Gll^Em, Rb, Wwf, Wwf^Ewl, Wwg^Ewl, Wwg^Es, Wwg^Es, Wwf, Wwf^Ewl, Wog, Wog, Md, Wog, Wog, Gll^Es, Wwg^Ewl, Gd^Edb, Gll^Fp, Md, Md, Gd^Efm, Gd^Efm, Gll^Efm, Gd^Edb, Gd^Vhr, Gd^Em, Hhd^Em, Hhd^Emf, Gll^Es, Wwf^Es, Wog, Gll^Es, Wwf, Gll^Es, Wog, Wwrg, Rb^Em, Gd, Gll^Edb, Gll^Edb, Gll
Hhd^Fdw, Gll^Fdw, Gll^Fdw, Rb^Efm, Rb^Efm, Gll^Efm, Gll, Gll^Fdw, Wwf^Es, Md, Wwf, Gll^Es, Md, Wwg^Es, Wwg, Wwf^Es, Wwf, Gll^Fdf, Gll^Fdf, Md, Md, Md, Md, Gll^Fdw, Gd^Edt, Gll, Gll^Esd, Hhd, Wog, Wwf, Wog, Wog, Gll^Edb, Gd^Es, Gd^Em, Md, Gll, Gll^Efm, Gll^Efm, Hhd, Md^Xm, Gll^Edb
Md, Hhd^Fdw, Md, Gll^Fmw, Re^Emf, Re^Vct, Re^Em, Gd^Edb, Gd^Em, Gd^Esd, Gll^Fdw, Gd^Em, Gll^Fdw, Wwg^Ewl, Wwf, Wwf, Wwf^Wkf, Wwf^Ewl, Md, Md, Md, Gll^Edb, Hhd^Fdf, Hhd^Fdw, Gll, Wwf, Wwf, Wwrg, Wwg^Ewl, Wwf, Wwg, Wwrg, Gd^Edb, Gll^Fdw, Gd^Emf, Hhd^Em, Hhd^Fp, Hhd, Hhd^Emf, Hhd^Emf, Md^Xm, Gll^Edb
Hhd^Em, Md, Md, Gll^Fdw, Re^Em, Wwf^Es, Wwf^Es, Re^Edb, Hhd^Edb, Hhd^Edb, Md, Gd, Gll^Fdw, Wwg^Ewl, Rb^Dr, Wwf^Wkf, Gll^Fmw, Md, Md, Md, Md, Gll^Edt, Gll^Edt, Gd^Edb, Wwf^Es, Gll^Esa, Wwg^Ewl, Wwg^Ewl, Wwf^Ewl, Wwf, Wwrg, Wwrg, Gd^Efm, Gd^Es, Gd^Es, Gd^Efm, Md, Hhd^Fp, Md^Xm, Md^Xm, Md^Xm, Md
Hhd^Fp, Hhd^Em, Hhd^Emf, Hhd^Em, Hhd^Em, Hhd^Fetd, Wwf^Es, Rb^Emf, Wwf, Wwf^Ewl, Md, Gll^Efm, Gll^Efm, Gll^Fdw, Gll^Es, Rb, Gd, Md, Gd^Efm, Md, Hhd^Vhhr, Md, Gll^Edb, Wwrg, Wwf^Es, Wwg, Wwg^Es, Wwrg, Wwf^Es, Wwf^Wkf, Wwf^Wkf, Gd^Efm, Gd, Hhd^Es, Md, Md, Md^Xm, Md^Xm, Md, Md^Xm, Md, Md
Wwg, Hhd^Fp, Hhd^Em, Md, Md, Wwf, Wog, Gd^Emf, Gd^Edb, Wwrg, Gll^Em, Gll^Efm, Gll^Fdf, Gll^Fdf, Gll^Fdf, Wwf, Gll^Fdf, Gd^Efm, Wwf, Gd^Efm, Gll^Efm, Gll^Edb, Wwg^Ewl, Wwf, Wwg^Ewl, Rb^Es, Rb^Efm, Wwf, Rb^Efm, Wwg, Gll, Gll^Efm, Gll, Hhd^Fp, Md, Md, Md, Md, Md, Md, Md, Md
Gd^Fp, Hhd^Fp, Hhd^Fp, Md, Hhd^Fp, Md, Wwf, Wwg^Ewf, Gll^Edb, Gd, Gd^Edb, Wwrg, Gll^Efm, Gd^Es, Wwf, Gd^Esd, Gll^Fdf, Gll^Fdf, Gll^Fdf, Gll^Fdf, Gll^Efm, Wwf, Wwf, Wwg^Ewf, Wwg^Wkf, Wwg^Wkf, Re^Em, Re^Vct, Gd^Efm, Gd, Md^Xm, Md^Xm, Md, Md, Md, Md, Md^Xm, Md, Hhd^Emf, Md^Es, Md, Md
Gll^Fp, Gll^Fmw, Gd^Fp, Hhd^Fp, Gd^Fp, Gll^Emf, Gll, Gll^Edb, Gd^Fp, Wwf, Gd^Fp, Gll, Gll^Esd, Gll^Fdf, Wwf^Ewf, Gll^Es, Gll^Fdf, Re, Gll^Es, Gd, Gd^Efm, Re^Edb, Gll^Es, Wwf, Wwrg, Wog, Gll^Esa, Gd^Efm, Hhd^Em, Md^Xm, Md, Md^Xm, Md, Md, Md, Md^Xm, Md, Md, Md^Xm, Hhd^Es, Md^Xm, Md^Xm
Wwg, Gll^Fp, Wog, Wwrg, Gd^Fp, Gll^Fmw, Gll^Fp, Wwg, Gll^Fp, Gd^Fp, Gll^Edb, Wwg, Gll^Es, Gll, Gll^Efm, Wwf, Gd^Efm, Gd^Es, Wog^Es, Wwf^Es, Wwf^Ewl, Rb, Gll^Es, Wwrg, Wog, Wog, Gll, Hhd^Em, Hhd^Efm, Md, Hhd^Fp, Md, Hhd^Emf, Hhd^Edb, Hhd^Edb, Md^Xm, Md^Xm, Md, Md, Hhd^Fp, Md, Md^Xm
Gll^Fp, Wwf, Gll^Fdw, Wog, Gd^Fp, Gd^Fp, Gll^Fdf, Gll^Fp, Gll^Em, Gll^Em, Wwf^Wkf, Wwg^Wkf, Wwg, Wwf^Es, Wwf, Gd^Vhr, Gll^Edb, Wog, Wwf^Ewf, Wwg, Wwf^Es, Gll^Es, Wwg^Es, Wwrg, Gll, Gll^Efm, Rb^Edb, Hhd^Em, Md, Hhd^Esa, Hhd^Esa, Hhd^Em, Md, Md, Md, Hhd^Es, Md^Xm, Md, Md, Md, Md, Md
Gll^Fp, Wwf^Wkf, Gll^Fp, Gll^Em, Gll^Efm, Wwf, Gd^Fp, Rb, Rb, Rb^Emf, Gll^Edb, Wwg^Es, Gll^Edb, Wog, Wwf, Wwf^Wkf, Wwf^Wkf, Wwf^Ewf, Wwg^Wkf, Wwf, Gll^Efm, Wwf, Gll^Emf, Wwg, Gll, Wwg, Wwf^Em, Rb^Edb, Wwrg, Md, Md, Md, Md, Md, Gll^Es, Hhd^Vhhr, Md, Md, Md, Md, Hhd^Fp, Md
Gd^Fp, Gll^Fp, Gll^Fdw, Gd^Fp, Cvr, Gd^Fp, Gd^Fetd, Gd^Fp, Gll^Fdf, Gll^Edb, Gd^Fp, Gd^Edb, Gll^Efm, Wwrg, Rb^Es, Wwf^Wkf, Gll^Es, Rb^Es, Wwg, Gll^Efm, Wwf, Rb, Rb^Es, Wwg, Gd^Fdw, Gll^Fdw, Gll^Esd, Wwf, Wwf^Es, Wwf^Ewl, Wwf^Ewl, Md, Md, Gd^Es, Gll^Edb, Md, Gd, Hhd^Em, Md, Md^Xm, Md, Md
Gll^Emf, Gd^Ve, Gll^Fp, Cvr, 3 Kvr, Cvr, Gd^Fp, Gd^Dr, Gll^Ve, Gll^Fmw, Gll^Fdw, Gd^Fp, Wwrg, Rb, Gll^Fdw, Rb, Gd^Esa, Gd^Es, Wwrg, Gll^Efm, Gll, Gd^Fdw, Rb^Efm, Rb^Es, Gd^Emf, Gd^Emf, Wwf, Wwf^Ewl, Gll^Es, Wwf^Es, Gll, Gll^Efm, Gll^Edb, Gd, Gll^Edb, Md, Gd^Es, Hhd, Hhd^Edb, Hhd^Edb, Md, Md
Gll^Fp, Gll^Fdw, Gd^Fp, Cvr, Cvr, Cvr, Gll^Fp, Gll^Fdw, Wog, Wwf, Gll^Fdw, Wwrg, Gll^Fp, Gd^Fp, Gd^Fp, Gd^Em, Gll, Wwf, Gll^Es, Wwrg, Rb, Gd^Efm, Aa^Esa, Gd^Efm, Gd^Ve, Gll^Edb, Gll^Edb, Gd^Esa, Re, Gll^Esa, Rb, Hhd, Md, Md, Hhd, Gll^Es, Hhd^Edb, Hhd, Hhd, Hhd^Edb, Hhd^Edb, Md
Gll^Fp, Gll^Fdw, Gll^Fmw, Gd^Fp, Gll^Fdf, Gll^Fp, Wwf^Wkf, Wwf^Wkf, Gll^Fp, Wog, Wwg^Es, Wwrg, Gll^Fdw, Gd^Fp, Wwf, Gll^Emf, Rb, Rb, Gll^Dr, Wwrg, Wwg, Gll, Aa^Esa, Aa^Efm, Ai^Esa, Ai, Gd^Efm, Gd^Esa, Gd^Esa, Re, Re^Em, Gd^Efm, Rb^Efm, Md, Gll^Efm, Gll, Gll^Esa, Gd, Gd^Esa, Gll^Efm, Hhd^Emf, Hhd^Edb
Md, Gll^Fdf, Md, Rb^Efm, Rb^Efm, Gll^Fdf, Md^Em, Md, Gd^Fp, Rb^Efm, Rb^Efm, Gll^Fp, Gd^Fp, Gll^Fp, Wwg, Gll^Em, Wwf, Gd^Vhr, Gll^Es, Wwrg, Gll^Fdw, Gll^Esa, Aa, Md, Md, Ai^Esa, Hhd^Esa, Gll^Em, Md, Gll^Emf, Md, Gll, Gd^Es, Hhd, Gd^Efm, Gd^Efm, Gd, Gd^Esa, Ha^Esa, Gll^Esa, Gll^Em, Gll^Efm
Md, Md, Md^Em, Gd^Fp, Rb^Efm, Gll^Fdf, Gd^Fp, Gd^Fetd, Gll^Efm, Gll^Dr, Gd^Esa, Gd^Fp, Wwrg, Wog, Gll^Em, Gll^Efm, Gd, Gd^Edb, Rb^Efm, Gll^Es, Gll^Esa, Gd, Aa^Esa, Md, Md^Xm, Md, Md, Hhd, Hhd, Md, Md, Gll^Es, Gll^Es, Gd^Esa, Gd^Esa, Re^Edb, Re^Edb, Gd^Efm, Ha, Ai^Esa, Ai, Ai
Gll^Fp, Wwf^Es, Wog, Gd^Fp, Wwrg, Gll^Esd, Gll^Efm, Gd, Gd, Gd^Em, Gd^Em, Gd^Fp, Gll^Efm, Gll^Efm, Gd, Gd^Edb, Re^Em, Re, Re, Rb^Efm, Gll, Aa^Esa, Md, Md, Md^Xm, Md^Xm, Md, Md, Hhd^Fp, Hhd^Fp, Md, Md, Md, Gd^Esa, Gd^Es, Gd^Fdw, Re^Efm, Gll^Efm, Ha^Vhca, Ha^Esa, Ha^Esa, Ha
Gll, Gd^Fp, Gll^Fdw, Wwrg, Gll^Fp, Rb, Gll^Efm, Wwrg, Gll^Fdf, Gll^Fdw, Gll^Fmw, Gll, Re, Gll^Efm, Md, Rb, Gll^Efm, Gll^Efm, Re^Em, Rb^Esd, Md, Md^Xm, Md, Md, Hhd^Emf, Md, Md^Xm, Hhd^Em, Hhd^Fp, Md, Md^Xm, Md, Ha^Es, Aa^Fma, Aa^Fmw, Gd^Fdw, Aa, Ha, Ha, Ha^Esa, Ha, Ha
Md, Gll^Fdw, Md, Gd^Fp, Wwf, Gll^Fdw, Gd^Efm, Re, Gll^Es, Wwg^Ewl, Re^Es, Re, Wwg^Es, Re, Md, Rb, Gll^Efm, Hhd, Hhd^Fmw, Re, Gd^Ve, Md, Hhd^Fp, Md, Hhd^Emf, Md^Xm, Hhd^Emf, Md^Xm, Hhd^Es, Md, Md^Xm, Ha^Vhca, Ha^Es, Aa^Fdw, Aa^Fda, Gd^Ecf, Cea^Edb, Cea^Edb, Cea, Aa^Es, Aa^Es, Ha
Md, Md^Xm, Md^Em, Hhd, Gd^Fetd, Gll^Fdf, Gd^Es, Rb, Gll^Es, Wwg, Wog, Wwg^Es, Wwg, Md, Wwf^Wkf, Md, Md, Md, Md, Hhd^Edb, Hhd^Em, Hhd^Fp, Gll^Edb, Hhd^Esa, Hhd^Esa, Md, Hhd^Em, Hhd^Es, Hhd^Fp, Hhd^Fp, Hhd^Edb, Ha^Esa, Aa^Fma, Aa^Fda, Md, Md, Cea, 1 Kea, Cea, Aa^Fma, Ai^Esa, Ha
Hhd^Emf, Md, Hhd^Em, Hhd^Em, Re^Edb, Re^Edb, Rb^Emf, Rb, Wwf, Gll^Efm, Gll^Efm, Wog^Ewf, Wog, Wwf, Wwg^Es, Md^Xm, Md, Md, Hhd^Edb, Hhd, Hhd^Em, Hhd^Fp, Gll^Esa, Gll^Edb, Hhd^Fp, Hhd, Ai, Ai, Ai, Ai, Gll^Esa, Re^Edb, Aa^Fma, Md, Md, Hhd^Emf, Hhd^Edb, Cea, Hhd^Fp, Ha^Vhca, Ai^Esa, Md^Em
Hhd^Fp, Hhd^Emf, Hhd^Fp, Gll^Fdw, Gll^Em, Gll^Em, Gll^Em, Wwf, Wwg^Ewl, Gll^Efm, Wog, Gll^Es, Wwf, Wwrg, Re^Em, Gll^Es, Gll^Fdw, Hhd^Fmw, Gll^Edb, Gll^Edb, Gll^Efm, Rb, Rb, Gd^Fetd, Gd^Fdw, Hhd^Fp, Hhd^Fp, Hhd^Fp, Gd^Fdw, Gll^Fdw, Gd^Edb, Gd^Em, Gll^Em, Aa^Em, Aa, Md, Gd^Fdw, Hhd^Edb, Md, Md, Ai^Esa, Md^Em
Hhd^Fp, Md, Gll^Fp, Gll^Em, Gd, Wwrg, Wwg, Wwg, Wwg, Wwg^Ewl, Wwg, Gll^Efm, Gll^Efm, Gd^Efm, Gd, Re, Gll, Hhd^Es, Gd^Em, Re^Em, Re^Em, Gd^Efm, Rb, Gd^Fdw, Gd^Edb, Gll^Fdw, Gd, Gll, Gll^Fdw, Gd, Re^Edb, Re^Edb, Gd, Gll^Fdw, Gd, Gd^Edb, Gd^Edb, Gll^Edb, Gll, Ai^Esa, Md, Md
