Gd, Gd, Hhd^Qhh, Md^Qhh, Md^Qhh, Md^Qhh, Md^Qhh, Hhd, Aa^Qhu, Aa^Qhu, Aa^Qhu, Re, Aa^Qhu, Aa^Qhu, Gd, Aa^Esa, Aa^Esa, Ai, Ai, Gd, Aa, Gd, Gll^Esa, Gll^Esa, Gll^Esa, Aa^Fpa, Gll^Fp, Gll^Fp, Aa^Fpa, Wwg, Ai, Ai, Aa, Aa, Aa, Aa, Aa, Aa, Aa, Aa^Qhu, Ha, Re, Re, Aa, Ha, Wwg, Wog, Wwg, Wog, Wwrg, Hhd^Qhh, Md^Qhh, Gd, Re, Aa^Fpa, Re, Aa^Fpa, Aa^Fpa, Wwg, Md, Wwg, Md, Md, Md, Gd^Em, Md, Md, Md, Md, Md, Aa, Hhd
Gd, Hhd^Esa, Md^Qhh, Md^Qhh, Md^Qhh, Md^Qhh, Md^Qhh, Md^Qhh, Wwg^Qhu, Wog^Qhu, Wwrg, Re^Qhu, Aa, Aa, Ai, Gll^Esa, Aa, Aa, Cha, Gll^Efm, Aa, Aa, Aa, Aa, Gll^Esa, Gd^Edt, Aa^Fpa, Aa^Fpa, Aa^Fpa, Wwg, Ai, Wwg, Ai, Aa, Aa, Aa, Aa, Aa, Aa^Qhu, Aa^Qhu, Ha, Ha, Aa, Re, Ha, Wwg, Wwrg, Wog, Re, Wog, Md^Qhh, Md^Qhh, Ha, Gll, Aa^Fpa, Aa^Fpa, Aa^Fpa, Wwg^Ewl, Wwrg, Wwg^Wkf, Wwg^Wkf, Wwg^Wkf, Md^Xm, Md, Re^Em, Md, Md, Md, Aa, Md^Xm, Md^Xm, Hhd^Fpa
Ha, Md^Qhh, Md^Qhh, Md^Qhh, Md^Qhh, Md^Qhh, Md^Qhh, Wog^Qhu, Wog^Qhu, Wwg, Wwrg, Re, Re, Aa, Gd^Esa, Gd^Esa, Aa, Cha, 3 Kha, Cha, Gll^Efm, Aa, Rb, Aa, Gll^Edt, Gd^Edt, Aa, Gll^Edt, Gd^Edt, Gll^Edt, Ai, Ai, Ai, Aa, Aa, Aa^Esa, Aa^Esa, Rb^Efm, Aa^Qhu, Hhd^Qhu, Hhd, Hhd, Gd^Esa, Re, Re, Wwrg^Ewl, Re, Re, Md^Qhh, Md^Qhh, Md^Qhh, Md^Qhh, Ms, Ha, Wwrg, Aa^Fpa, Wwrg^Ewl, Wwrg^Ewl, Aa^Fpa, Md, Md, Md, Md, Md, Md, Re^Em, Gd^Vh, Md^Em, Aa, Md^Xm, Hhd^Fpa, Hhd^Fp
Gll^Fp, Hhd, Md^Qhh, Md^Qhh, Md^Qhh, Md^Qhh, Md^Qhh, Md^Qhh, Wog^Qhu, Wwg^Wkf, Wwf^Ewl, Wwrg, Gll^Edt, Re^Edt, Re^Qhu, Aa^Edt, Aa, Cea, Cea, Cea, Gll^Efm, Rb, Cha, Aa, Aa, Aa, Aa^Fpa, Aa^Fpa, Gd, Gll^Es, Gll^Es, Wwg, Wog, Aa, Aa^Esa, Aa^Qhu, Re^Qhu, Rb^Qhu, Hhd, Hhd^Esa, Hhd^Esa, Hhd^Esa, Aa^Fpa, Gd, Hhd, Re, Hhd, Md^Qhh, Md^Qhh, Md^Qhh, Md^Qhh, Md^Qhh, Ms, Wwg, Wwrg, Wwrg, Aa^Fpa, Aa^Fpa, Gll^Esa, Aa^Fpa, Aa^Fpa, Gll^Fp, Aa^Fpa, Aa^Fpa, Cha, Re^Es, Aa^Fpa, Aa^Fpa, Md, Md^Xm, Ms, Ms
Gd^Efm, Rb^Efm, Hhd^Em, Md^Qhh, Ms^Qhh, Ms^Qhh, Md^Qhh, Md^Qhh, Wog^_ml, Wwg^Qhu, Wwf^Ewl, Wwrg, Gll^Edt, Rrc^Qhu, Re, Aa, Aa^Dr, Aa, Gd^Ecf, Gll, Cha^Efm, Cha^Eb, Gd, Aa, Gll^Fp, Aa^Fpa, Aa^Fpa, Aa^Fpa, Aa^Fpa, Aa^Fpa, Wwrg^Es, Aa, Wog, Aa, Wwrg, Re^Qhu, Gd^Qhu, Gd^Qhu, Gll^Fp, Hhd, Hhd, Hhd^Esa, Aa^Fpa, Hhd, Hhd, Hhd^Vhh, Md^Qhh, Md^Qhh, Md^Qhh, Md^Qhh, Md^Qhh, Ms, Wwg, Wwg^Wkf, Wog, Md, Gd, Gll^Esa, Aa^Fpa, Gll^Fp, Gll^Fp, Gll^Fp, Gll^Fp, Gll^Fp, Aa^Fpa, Re^Es, Aa^Fpa, Hhd^Fp, Md, Hhd^Fpa, Ms, Ms
Gd^Efm, Rb, Hhd^Em, Hhd^Emf, Ms^Qhh, Ms^Qhh, Ms^Qhh, Md^Qhh, Wwg^Qhu, Wwg, Wwf, Gll^Edt, Gll, Gll^Efm, Re, Aa, Gll^Fp, Gd^Esa, Gd^Qhu, Gll^Efm, Rb, Aa, Gd^Vh, Gll, Ww, Aa^Fpa, Aa^Fpa, Aa^Fpa, Aa^Fpa, Aa^Esa, Wwrg, Wwg, Wog, Wog, Wwrg, Ai^Qhu, Gll^Qhu, Gd^Qhu, Aa^Fpa, Gll^Fp, Hhd, Hhd, Hhd, Hhd, Hhd^Esa, Md^Qhh, Hhd^Esa, Md^Qhh, Md^Qhh, Md^Qhh, Ms, Ms^Qhh, Ai, Wog, Wog, Md, Hhd, Gd^Esa, Aa^Fpa, Gll^Fp, Gd, Gd, Rb, Aa^Fpa, Gll^Es, Re^Es, Md^Xm, Md, Rb, Rb, Hhd, Hhd^Fpa
Gd^Efm, Rb, Gll^Fp, Hhd^Em, Ms^Qhh, Ms^Qhh, Ms^Qhh, Ms^Qhh, Wwf^Qhu, Wwf^Qhu, Hhd, Hhd, Gd, Gll^Efm, Re^Efm, Gd, Gll^Fp, Gll^Fp, Aa^Fpa, Gd^Qhu, Gll^Qhu, Gd^Esd, Gll^Fp, Gll^Fp, Gll^Fp, Gll^Fp, Gll^Fp, Gll^Fp, Gll^Fp, Wwf, Wwrg, Aa^Esa, Aa^Fpa, Wwrg, Wwf, Ai^Qhu, Aa^Qhu, Gll^Qhu, Aa^Fpa, Aa^Fpa, Aa^Fpa, Hhd, Hhd, Ha, Hhd, Hhd^Esa, Hhd^Esa, Hhd^Esa, Md^Qhh, Md^Qhh, Md^Qhh, Ms, Wwg, Wwrg, Wog, Ms, Re, Re, Rb^Esa, Aa^Fpa, Gd, Rb^Dr, Gll^Fp, Aa^Fpa, Rb, Re, Aa^Esa, Aa^Esa, Aa, Ha, Hhd^Esa, Hhd
Gll^Fp, Hhd^Em, Hhd^Emf, Hhd^_mh, Ms^Qhh, Ms^Qhh, Ms^Qhh, Ms^Qhh, Ms^Qhh, Wwf^Qhu, Wwf^Qhu, Aa^Fpa, Gd, Re, Gd^Vh, Gll^Fp, Gll, Gll, Rb^Edb, Gd^Efm, Re, Re^Qhu, Re^Qhu, Aa^Fpa, Aa^Fpa, Aa^Fpa, Gll^Fp, Hhd, Wwg^Wkf, Wwf, Wwg, Aa^Esa, Aa^Qhu, Wwg, Ai^Qhu, Aa^Qhu, Ai^Qhu, Gll^Qhu, Gd^Vh, Gll^Qhu, Gd^Qhu, Gll^Qhu, Ha^_ml, Gd, Ha, Gd, Hhd^Esa, Md^Qhh, Md^Qhh, Md^Qhh, Md^Qhh, Ms, Wwg, Wwrg, Md^Qhh, Hhd, Re^Esa, Rb^Esa, Rb, Aa^Fpa, Gll^Fp, Gll^Fp, Aa^Fpa, Rb, Re^Em, Re^Esa, Aa, Aa, Ha, Ha, Hhd^Esa, Hhd
Hhd, Hhd, Md^Qhh, Ms^Qhh, Ms^Qhh, Ms^_mh, Ms^Qhh, Ms^Qhh, Ms^Qhh, Ms^Qhh, Hhd, Wwg, Gll^Fp, Wwg, Wwrg, Wwrg, Ai, Aa, Ai, Gd^Edb, Re, Re^Wm, Gd, Gd^Efm, Rb^Efm, Aa^Fpa, Hhd, Wwg^Wkf, Wwf^Es, Wwf^Es, Wog, Aa^Esa, Wwg^Qhu, Aa^Qhu, Aa^Qhu, Ai^Qhu, Ai^Qhu, Ai^Qhu, Ai^Qhu, Gd^Qhu, Gd^Qhu, Gll^Qhu, Aa^Fpa, Aa^Fpa, Aa^Fpa, Hhd^Esa, Hhd^Esa, Md^Qhh, Md^Qhh, Md^Qhh, Md^Qhh, Md^Qhh, Md^Qhh, Md^_mh, Aa^Qhh, Re, Gd, Aa^Fpa, Aa^Fpa, Aa^Em, Aa^Fpa, Aa^Fpa, Re, Re, Gd, Aa^Em, Ms, Ms, Ha, Ha, Hhd^Esa, Ha^Fpa
Md^Qhh, Md^Qhh, Md^Qhh, Md^Qhh, Ms^Qhh, Ms^Qhh, Ms^Qhh, Ms^Qhh, Hhd^Emf, Hhd^Em, Aa^Fpa, Wog, Wwg, Ww^Bw|, Wog, Aa, Ai, Ai, Rb, Rb^Edb, Rrc, Gd^Edb, Aa, Aa, Rb^Efm, Aa^Fpa, Hhd, Wwg^Wkf, Hhd^Esa, Wwg, Wwf, Wwg^Qhu, Aa^Qhu, Aa^Qhu, Aa^Esa, Aa^Qhu, Aa^Qhu, Aa^Qhu, Aa^Qhu, Aa^Qhu, Wwrg^Qhu, Gll^Qhu, Aa^Fpa, Aa^Fpa, Aa^Fpa, Hhd, Md^Qhh, Md^Qhh, Ms^Qhh, Ms^Qhh, Md^Qhh, Md^Qhh, Hhd^Qhh, Aa^Qhh, Ms^Qhh, Aa^Qhh, Aa^Qhh, Aa^Vha, Re^Em, Re^Em, Re, Gd, Cha, Aa^Fpa, Aa^Fpa, Aa^Fpa, Aa^Fpa, Gll^Fp, Aa^Esa, Hhd^Esa, Ha^Fpa, Ha^Fpa
Md^Qhh, Md^Qhh, Md^Qhh, Md^Qhh, Md^Qhh, Ha, Ha^Esa, Ha^Em, Gd^Efm, Gd^Em, Gd^Em, Gll^Em, Gll, Cha, Gll, Rb, Rb, Rb, Aa^Fpa, Re^Edb, Rrc, Ai, Aa^Vha, Gd^Efm, Rb, Hhd, Mm, Hhd, Hhd^Esa, Wwg, Wwf, Ha^Qhu, Aa^Qhu, Aa, Aa, Aa, Aa, Aa^Esa, Aa^Esa, Gll^Esa, Gll, Wwrg^Qhu, Wwrg^Qhu, Gll^Fp, Gll^Fp, Hhd, Md^Qhh, Ms^Qhh, Ms^Qhh, Ms^Qhh, Ms^Qhh, Md^Qhh, Hhd^Qhh, Aa^Qhh, Aa^Qhh, Ms^Qhh, Aa^Qhh, Aa^Qhh, Gd^Em, Gd^Dr, Re, Cha, Cha^Eb, Aa^Fpa, Gll^Fp, Rb, Rb^Esd, Gll^Fp, Aa^Fpa, Aa^Vha, Ha, Ha
Md^Qhh, Md^Qhh, Md^Qhh, Hhd, Hhd, Md^Qhh, Ha^Esa, Ha, Gd^Efm, Aa, Gd, Gd^Efm, Aa, Re, Gll^Efm, Gll^Efm, Aa^Fpa, Gd, Gd^Edb, Gd^Edb, Rrc, Rrc, Aa^Fpa, Gd^Efm, Wwf^Wkf, Wwf^Wkf, Hhd, Hhd, Hhd^Em, Hhd^Esa, Hhd^Em, Aa^Qhu, Gd, Aa^Esa, Aa, Aa, Aa, Aa, Gd, Gll, Gll, Wwg, Wwg^Wkf, Wwrg^Qhu, Wwrg^Qhu, Wwrg^Qhu, Hhd^Qhu, Wwf^Qhu, Ms^Qhh, Ms^Qhh, Ms^Qhh, Wwf^Qhh, Hhd^Qhh, Hhd^Qhh, Ms^Qhh, Ms^Qhh, Aa^Qhh, Wwf, Re^Efm, Re, Ai, Re, Re, Aa^Fpa, Gd^Efm, Rb, Gd^Es, Rb, Hhd^Fp, Aa^Fpa, Aa^Fpa, Aa^Fpa
Hhd, Hhd, Hhd^Esa, Hhd^Esa, Hhd^Esa, Hhd, Hhd, Gd^Efm, Gll^Efm, Aa, Aa, Aa, Aa, Re, Gll^Efm, Aa^Fpa, Wwf^Wkf, Gll, Rb, Gd, Wwrg, Wwrg, Wwrg, Wwf^Wkf, Wwf^Ewf, Gll^Fp, Gll^Fp, Gll^Fp, Hhd^Emf, Hhd^Emf, Gll^Fp, Gll^Fp, Hhd, Aa, Aa, Ha, Ha, Hhd, Aa^Fpa, Aa^Fpa, Gll^Esa, Wog, Wog, Wwg^Ewl, Wog, Wog, Wog, Wwf, Wwf, Ms^Qhh, Wwrg, Wwrg^Qhh, Hhd^Qhh, Hhd^Qhh, Aa^Qhh, Ms^Qhh, Wwf, Wwf, Re^Efm, Ai, Aa, Gd^Es, Re, Gll^Fp, Gd^Efm, Aa, Chr, Aa^Vha, Md^Xm, Hhd^Fp, Hhd^Fp, Md
Hhd, Gd^Efm, Rb, Aa^Fpa, Aa^Fpa, Hhd^Esa, Hhd^Ve, Gll, Aa, Aa, Aa, Aa, Aa, Re, Re, Wwf^Es, Gd^Es, Gll, Re^Wm, Re, Gll^Efm, Gd^Efm, Gd^Efm, Wwf^Wkf, Wwf^Es, Wwf, Wwf^Wkf, Wwf, Gll^Fp, Gd^Em, Rb^Efm, Hhd, Hhd, Hhd, Ha, Ha, Ha, Ha, Hhd^Em, Aa^Fpa, Aa^Fpa, Gd^Em, Ai, Wog, Ai, Ai, Ai, Wwf^Wkf, Wwrg, Wwrg, Wwrg, Gd^Qhh, Rb^Efm, Gll^Efm, Aa^Qhh, Aa^Qhh, Wwf, Gd^Efm, Re^Efm, Wwf, Wwf, Wwf^Es, Wwf, Re^Ecf, Re^Efm, Chr, 2 Khr, Cha, Md, Md^Xm, Md, Md
Gd, Gd, Rrc, Aa^Fpa, Cea, Aa^Fpa, Gll^Fp, Gll, Aa^Fpa, Aa^Esa, Aa^Esa, Aa, Gd^Esa, Gd^Esa, Aa^Fpa, Re, Re^Es, Gll^Efm, Re, Gll, Gd, Gll, Gd^Efm, Wwf^Es, Ch^Edb, Cvr, Cvr, Gll, Aa^Fpa, Gll, Rb, Hhd^Efm, Hhd^Efm, Hhd^Esa, Ha, Ha, Ha, Ms, Ha^Em, Hhd^Emf, Hhd, Hhd^Em, Ai, Ai, Ai, Ai, Wwf, Wwrg, Re, Re, Re, Re^Qhh, Re^Wm, Rb, Rb^Efm, Cha^Qhh, Re, Re^Efm, Gd^Vh, Wwg, Wwg^Ewl, Ms, Ms, Rb, Ms, Chr, Chr, Ch, Ms, Ha^Dr, Md, Md
Aa^Fpa, Gll^Edb, Gll^Edb, Ch^Edb, 1 Kh, Cea, Aa^Fpa, Aa^Fpa, Rb, Rb, Re^Esa, Gd^Esa, Wwf, Gll^Fp, Gd, Gd, Re^Efm, Gd, Gd, Gll^Fp, Aa^Fpa, Gll^Fp, Gd^Vhr, Aa^Fpa, Ch^Edb, 4 Kh, Cvr, Gll, Gd^Vhr, Gll^Dr, Gd, Rb, Re, Hhd, Rb^Esa, Aa^Vha, Rb^Esa, Ha, Ha^Em, Ha, Hhd, Hhd^Em, Aa, Ai^Es, Ai, Ai, Wwf^Wkf, Aa, Re, Gd^Vh, Gd^Efm, Gll^Qhh, Gll, Gll, Re, Re, Gd^Qhh, Gd^Esa, Rb, Wwg, Aa^Fpa, Ms, Ms, Ms, Gd^Vh, Md, Gll^Fp, Gll^Fp, Ms, Ha, Ha, Md
Gll^Fp, Aa^Fpa, Aa^Vha, Ch^Edb, Ch^Edb, Cea, Re^Edb, Aa^Fpa, Re^Edb, Re^Edb, Gll, Re, Re, Gll^Fp, Re, Re^Efm, Rrc^Efm, Re^Efm, Re^Efm, Aa^Fpa, Aa, Aa^Fpa, Mm, Aa^Fpa, Gd^Ecf, Ch, Rb^Efm, Aa^Fpa, Aa^Fpa, Gll^Fp, Gd^Em, Re^Efm, Gll, Rb^Esa, Gd, Rb^Esa, Aa^Fpa, Hhd, Gll, Rb, Ha, Ha, Rb, Wwf, Wwrg, Wwrg, Re, Aa, Re, Aa, Gd^Efm, Gll^Qhh, Wwrg, Wwrg, Gd, Wwf^Ewf, Rb, Aa^Qhh, Aa^Qhh, Wog, Gd, Aa^Fpa, Ms, Md, Md, Rb, Gll^Fp, Aa^Fpa, Gll^Fp, Ms^Xm, Ms, Ha
Gd, Gd, Aa^Fpa, Rrc, Re, Aa, Re^Ecf, Re^Edb, Gll, Gll^Edb, Gll, Wwf^Wkf, Aa^Fpa, Re, Gd, Gll^Efm, Rrc, Gll^Fp, Aa^Fpa, Re, Re, Gd^Efm, Re, Aa, Cvr, Re, Cvr, Gd, Rb^Esa, Gll^Fp, Re, Re, Gll, Gd, Gll, Gd, Gd^Em, Gll, Gll, Rb^Efm, Aa, Aa, Re^Es, Re^Es, Re, Re^Efm, Gd^Efm, Re, Aa, Aa, Gd^Efm, Gll^Qhh, Wwrg, Wwrg, Wwf^Ewf, Wwf^Ewf, Re^Qhh, Rb^Qhh, Rb^Qhh, Wog, Wwg, Aa^Fpa, Aa^Fpa, Ms, Rb, Rb^Esa, Aa^Fpa, Gd, Aa^Fpa, Aa^Fpa, Aa^Fpa, Md
Gd, Gd^Ve, Aa^Fpa, Rrc, Aa^Esa, Re, Gd^Efm, Gd^Esa, Aa^Fpa, Aa^Fpa, Gll, Gll, Aa^Fpa, Gll^Fp, Gd^Es, Rb^Efm, Rb, Rrc, Aa^Fpa, Aa^Fpa, Gd, Re, Aa, Re^Esa, Aa^Esa, Cvr, Aa^Esa, Re^Esa, Re, Rb^Esa, Aa^Fpa, Aa^Fpa, Aa^Fpa, Re^Edb, Gll, Gll, Gll^Fp, Gll^Fp, Aa^Fpa, Rb, Rb^Efm, Re^Es, Aa, Gd^Efm, Wwrg, Wwf^Ewf, Wwf, Gll, Gd, Aa, Gd, Wwf^Wkf, Wwf^Wkf, Wwf^Wkf, Wwf^Es, Gd^Qhh, Wwf, Wwf^Wkf, Wwf, Wwg, Gd^Esa, Aa^Fpa, Aa^Fpa, Aa^Fpa, Aa^Fpa, Aa^Fpa, Gll^Esa, Gll^Es, Md, Md, Aa^Fpa, Md
Gd, Gll^Fp, Aa^Fpa, Rrc^Esa, Re, Re^Esd, Aa^Fpa, Aa^Fpa, Gll^Fp, Aa^Fpa, Gd^Efm, Gll, Gll^Efm, Aa^Fpa, Aa^Fpa, Gd^Es, Rb, Rrc, Gll^Fp, Gll^Fp, Gd, Aa, Aa, Aa, Aa^Esa, Aa^Esa, Aa, Aa, Aa, Re, Re, Aa, Re, Re^Edb, Re, Gd^Em, Aa^Fpa, Aa^Fpa, Aa^Fpa, Gd, Re^Es, Re, Gd, Wwrg, Wwf, Wwf, Wwf^Ewl, Wwf^Ewl, Gll^Fp, Aa^Fpa, Gll^Fp, Wwf^Wkf, Wwf, Wwf^Es, Gd^Es, Wwrg, Wwf, Gll^Qhhf, Gll^Qhhf, Gll^Qhhf, Aa^Fpa, Gd^Es, Gll^Es, Aa, Aa^Esa, Aa, Aa^Vha, Aa, Aa, Md, Md, Md
Gll^Fp, Aa^Fpa, Gll^Es, Re, Aa^Es, Rrc, Aa^Fpa, Wwrg, Gll^Fp, Aa^Fpa, Gd^Efm, Aa, Aa^Esa, Ha, Ha, Hhd^Esa, Gll^Fp, Gll^Fp, Gd, Gll^Fp, Gd, Gll^Es, Aa, Rb, Ai, Aa, Aa, Aa, Aa, Aa, Aa, Re, Aa, Aa, Aa, Re^Em, Re, Aa, Re, Re, Aa, Aa^Es, Re, Wwrg, Wwg^Ewl, Wwg^Ewl, Wwg^Wkf, Wwg, Wwg, Gll, Gd^Em, Gll^Fp, Wwf, Gll, Gll^Efm, Wwf, Gll^Qhhf, Gll^Qhhf, Gd, Gd, Gll^Fp, Gll, Aa, Aa^Esa, Aa, Aa, Gll^Es, Rb, Aa, Md, Md, Md
Gll, Gd^Efm, Re^Efm, Re, Gll^Em, Aa^Fpa, Wwf^Ewl, Wwrg, Gll^Fp, Aa^Fpa, Gd^Efm, Aa^Esa, Aa, Ha^Esa, Ha, Hhd^Esa, Aa^Fpa, Gll^Fp, Gll^Fp, Gll^Fp, Gd, Gll^Es, Gll^Es, Aa^Fpa, Wog, Rb, Gd, Aa, Aa, Aa, Aa, Aa, Aa, Aa, Aa, Aa, Aa, Re, Aa, Aa^Es, Aa, Aa^Es, Ai^Es, Wwg^Es, Wwg, Wwg^Ewl, Wwg, Wwg, Wwg^Wkf, Gll^Esa, Gll^Em, Wwf, Gd^Em, Gll^Efm, Aa^Fpa, Gll^Qhhf, Gll^Qhhf, Gll^Qhhf, Gd, Hhd^Fp, Gll^Fp, Gll^Efm, Gll, Aa, Aa, Gll^Efm, Gd^Efm, Rb, Rb, Md, Md, Md
