Xu, Xu, Wwg, Wog, Xu, Wog, Wwg, Xu, Xu, Xu, Xu, Xu, Xu, Xu, Xu, Xu, Xu, Xu, Xu, Xu, Xu, Xu, Xu, Xu, Xu, Xu, Xu, Xu, Xu, Xu, Xu, Xu, Xu, Xu, Xu, Xu, Xu, Xu, Xu, Xu, Xu, Xu, Xu, Xu
Xu, Xu, Wwg, Wwg, Xu, Wwg, Wwg, Xu, Xu, Xu, Xu, Xu, Xu, Xu, Xu, Xu, Xu, Xu, Xu, Xu, Xu, Xu, Xu, Xu, Xu, Xu, Xu, Xu, Xu, Xu, Xu, Xu, Xu, Xu, Xu, Xu, Xu, Xu, Xu, Xu, Xu, Xu, Xu, Xu
Xu, Xu, Xu, Wwg^Bw\r, Isa, Wwg^Bw/r, Xu, Xu, Xu, Xu, Xu, Xu, Qxua, Xu, Xu, Xu, Xu, Xu, Xu, Xu, Xu, Xu, Xu, Xu, Xu, Xu, Xu, Xu, Xu, Xu, Xu, Xu, Xu, Xu, Xu, Xu, Xu, Xu, Xu, Xu, Xu, Xu, Xu, Xu
Xu, Xu, Xu, Uu, Isa, Isa^Edb, Isa^Edb, Xu, Xu, Xu, Uh, Uh, Uh^Em, Qxua, Xu, Xu, Xu, Xu, Xu, Xu, Xu, Xu, Xu, Xu, Xu, Xu, Xu, Xu, Xu, Xu, Xu, Xu, Uh^Emf, Qxua, Qxua, Xu, Xu, Xu, Xu, Xu, Xu, Xu, Xu, Xu
Xu, Xu, Xu, Xu, Xu, Xu, Xu, Uu^Pr/, Uu^Edb, Uu^Emf, Cud, Cud, Cud, Uh^Em, Qxua, Xu, Xu, Xu, Xu, Xu, Uh^Em, Xu, Isa, Xu, Xu, Xu, Xu, Xu, Xu, Xu, Uu^Em, Uh^Emf, Uu, Uh, Uh, Qxua, Xu, Xu, Xu, Xu, Xu, Xu, Xu, Xu
Xu, Xu, Xu, Xu, Xu, Xu, Qxu, Uu, Uh^Emf, Uh^Emf, Cud, Kud, Cud, Qxua, Uh, Uh, Isa, Xu, Isa, Uu^Em, Uu, Isa, Uu^Emf, Isa, Xu, Xu, Xu, Xu, Xu, Xu, Uu^Em, Uu^Em, Isa, Isa^Edb, Isa^Edb, Qxua, Xu, Xu, Xu, Xu, Xu, Xu, Xu, Xu
Xu, Xu, Xu, Xu, Qxua, Qxu, Uu, Uu, Uu, Uh, Isa, Cud, Uu^Edb, Qxua, Uu, Uu, Uh^Edb, Isa, Uh, Uh, Uh, Uu, Uu^Pr/, Xu, Uu^Edb, Isa^Edb, Qxua, Xu, Xu, Xu, Uu, Xu, Uu, Uu, Xu, Xu, Xu, Xu, Xu, Xu, Xu, Xu, Xu, Xu
Xu, Xu, Xu, Xu, Xu, Qxua, Isa, Isa, Uh, Uh^Em, Uu, Isa^Edb, Isa, Isa^Edb, Xu, Uu, Uh, Uu^Emf, Xu, Xu, Xu, Xu, Xu, Uu, Uu^Em, Isa^Edb, Qxua, Xu, Qxua, Uh, Uh, Isa, Uh, Xu, Xu, Xu, Xu, Xu, Xu, Xu, Xu, Xu, Xu, Xu
Xu, Xu, Xu, Xu, Xu, Xu, Xu, Uh^Emf, Xu, Uh, Uu, Xu, Xu, Xu, Xu, Xu, Xu, Xu, Xu, Xu, Xu, Xu, Uh, Uh^Emf, Uu^Em, Isa^Edb, Isa^Edb, Qxua, Isa, Uu, Uh, Xu, Xu, Xu, Xu, Xu, Xu, Xu, Xu, Xu, Xu, Xu, Xu, Xu
Xu, Xu, Xu, Xu, Xu, Xu, Xu, Xu, Qxu, Uh, Uu, Uh^Emf, Uh^Emf, Qxu, Qxu, Xu, Xu, Xu, Xu, Xu, Xu, Xu, Qxu, Uh, Isa, Uu^Em, Uh, Isa^Edb, Uh, Uu, Uu^Pr/, Xu, Uh, Xu, Xu, Xu, Xu, Xu, Xu, Xu, Xu, Xu, Xu, Xu
Xu, Xu, Xu, Xu, Xu, Xu, Xu, Xu, Xu, Qxua, Qxua, Uu, Uu, Uu^Emf, Xu, Xu, Xu, Xu, Xu, Xu, Xu, Qxu, Uh^Em, Uh, Isa, Uu, Xu, Uh^Em, Xu, Xu, Uu, Uu, Uh^Em, Uh^Emf, Xu, Xu, Xu, Xu, Xu, Xu, Xu, Xu, Xu, Xu
Xu, Xu, Xu, Xu, Xu, Xu, Xu, Xu, Xu, Xu, Xu, Xu, Xu, Uu^Pr/, Uu, Xu, Xu, Xu, Xu, Xu, Xu, Isa, Isa, Isa, Xu, Xu, Xu, Xu, Xu, Xu, Qxua, Uu^Emf, Uu^Em, Xu, Xu, Xu, Xu, Xu, Xu, Xu, Xu, Xu, Xu, Xu
Xu, Xu, Xu, Xu, Xu, Xu, Xu, Xu, Xu, Xu, Isa^Edb, Uh^Emf, Uh, Uh, Uu, Xu, Xu, Xu, Xu, Xu, Qxu, Uu, Uu^Emf, Isa, Xu, Xu, Xu, Xu, Xu, Qxua, Cud, Isa^Edb, Isa^Edb, Xu, Xu, Xu, Xu, Xu, Xu, Xu, Xu, Xu, Xu, Xu
Xu, Xu, Xu, Xu, Xu, Xu, Xu, Xu, Xu, Isa^Edb, Uu, Uu^Edb, Uu, Isa, Uu, Isa, Xu, Xu, Xu, Xu, Qxua, Uu, Uh^Emf, Xu, Xu, Xu, Qxu, Xu, Xu, Cud, Kud, Cud, Isa^Edb, Uh, Xu, Xu, Xu, Xu, Xu, Xu, Xu, Xu, Xu, Xu
Xu, Xu, Xu, Xu, Xu, Xu, Qxua, Xu, Xu, Isa, Uu^Em, Qxua, Xu, Uu, Isa, Isa, Xu, Xu, Xu, Xu, Xu, Uh, Xu, Xu, Xu, Qxua, Uh, Qxu, Isa, Cud, Cud, Cud, Isa^Edb, Uh^Emf, Xu, Xu, Xu, Xu, Xu, Xu, Xu, Xu, Xu, Xu
Xu, Xu, Xu, Xu, Xu, Xu, Qxua, Qxua, Uu, Uu^Emf, Uh^Emf, Uh^Emf, Xu, Xu, Xu, Xu, Xu, Xu, Xu, Xu, Xu, Xu, Xu, Xu, Xu, Uh, Isa^Edb, Uu, Isa, Isa^Edb, Uu, Uu, Uh, Uh, Xu, Xu, Xu, Xu, Xu, Xu, Xu, Xu, Xu, Xu
Xu, Xu, Xu, Xu, Uh, Xu, Qxua, Uu, Isa, Isa, Uh^Em, Xu, Xu, Xu, Xu, Xu, Xu, Xu, Xu, Xu, Xu, Xu, Xu, Xu, Qxua, Uu, Uu^Edb, Uu, Qxua, Xu, Xu, Uu, Xu, Xu, Xu, Xu, Xu, Xu, Xu, Xu, Xu, Xu, Xu, Xu
Xu, Xu, Xu, Xu, Uh^Emf, Uh^Em, Isa, Isa, Uh, Uh^Emf, Xu, Xu, Xu, Xu, Xu, Xu, Xu, Xu, Xu, Xu, Xu, Xu, Xu, Xu, Qxua, Uh, Qxua, Uu^Emf, Uh^Em, Qxua, Xu, Xu, Xu, Xu, Xu, Xu, Xu, Xu, Xu, Xu, Xu, Xu, Xu, Xu
Xu, Xu, Xu, Xu, Xu, Isa, Uu^Emf, Isa, Qxua, Xu, Xu, Xu, Xu, Xu, Xu, Xu, Xu, Xu, Xu, Xu, Xu, Xu, Xu, Xu, Xu, Qxua, Xu, Uu, Isa^Em, Uh^Emf, Xu, Xu, Xu, Xu, Xu, Xu, Xu, Xu, Xu, Xu, Xu, Xu, Xu, Xu
Xu, Xu, Xu, Xu, Qxua, Xu, Cud, Uu^Edb, Uh^Edb, Qxua, Uh, Xu, Xu, Uh, Uh^Emf, Xu, Xu, Xu, Xu, Xu, Xu, Xu, Xu, Xu, Xu, Xu, Xu, Uu, Isa^Edb, Uh, Xu, Xu, Xu, Xu, Xu, Xu, Xu, Xu, Xu, Xu, Xu, Xu, Xu, Xu
Xu, Xu, Xu, Xu, Isa^Edb, Cud, Kud, Cud, Isa^Edb, Isa, Isa, Uh, Isa^Edb, Isa^Emf, Uh^Em, Xu, Xu, Xu, Xu, Xu, Xu, Xu, Xu, Xu, Xu, Xu, Xu, Uu, Uu, Isa, Uu, Uu, Uu^Pr/, Xu, Uh^Emf, Xu, Xu, Xu, Xu, Xu, Xu, Xu, Xu, Xu
Xu, Xu, Xu, Uh^Emf, Uu^Edb, Cud, Cud, Cud, Qxua, Uu^Em, Uu, Isa^Edb, Uu, Isa^Edb, Isa, Xu, Xu, Xu, Xu, Xu, Xu, Xu, Xu, Xu, Xu, Xu, Xu, Xu, Xu, Isa, Xu, Xu, Qxu, Uu, Isa^Edb, Uh, Xu, Xu, Xu, Xu, Xu, Xu, Xu, Xu
Xu, Xu, Xu, Uh^Emf, Xu, Qxua, Qxua, Qxua, Xu, Uu^Emf, Qxua, Qxua, Uu, Uu^Em, Xu, Xu, Uh, Xu, Xu, Xu, Xu, Xu, Xu, Xu, Xu, Xu, Xu, Xu, Xu, Xu, Xu, Qxu, Xu, Isa, Isa, Uh^Edb, Xu, Xu, Xu, Xu, Xu, Xu, Xu, Xu
Xu, Xu, Xu, Uh, Xu, Xu, Xu, Xu, Xu, Xu, Xu, Xu, Xu, Uu^Pr/, Uu, Uh, Uh, Qxua, Xu, Xu, Uh, Uh, Xu, Xu, Qxu, Qxu, Uh, Qxua, Xu, Xu, Xu, Xu, Qxua, Xu, Qxu, Isa, Uu^Emf, Xu, Xu, Xu, Xu, Xu, Xu, Xu
Xu, Xu, Xu, Isa^Edb, Isa^Edb, Xu, Xu, Xu, Xu, Xu, Xu, Xu, Uu^Emf, Uu^Edb, Uu, Qxu, Uh^Emf, Qxu, Isa, Xu, Isa, Uh, Uh^Edb, Qxu, Uh^Emf, Uh^Emf, Isa^Edb, Uh, Uh, Xu, Qxua, Qxua, Qxua, Qxu, Isa, Isa, Uh^Emf, Uh^Emf, Xu, Xu, Xu, Xu, Xu, Xu
Xu, Xu, Xu, Uu^Edb, Isa^Edb, Uh, Qxua, Xu, Xu, Xu, Xu, Xu, Isa^Edb, Isa^Edb, Xu, Uu, Uu^Em, Uh^Emf, Isa, Xu, Uh, Isa, Uu, Uh^Em, Uu^Emf, Isa^Edb, Uu, Isa^Edb, Isa^Edb, Isa, Uh, Uh, Uh, Uh, Uu, Uh^Emf, Xu, Xu, Xu, Xu, Xu, Xu, Xu, Xu
Xu, Xu, Xu, Uu^Emf, Uh^Emf, Uh^Emf, Qxua, Xu, Xu, Xu, Xu, Xu, Xu, Xu, Uu, Isa, Isa^Edb, Xu, Isa, Xu, Xu, Isa, Uu, Uu, Qxu, Uu, Qxua, Xu, Xu, Uu^Edb, Uu, Uu, Uu, Uu, Isa, Uh, Xu, Xu, Xu, Xu, Xu, Xu, Xu, Xu
Xu, Xu, Xu, Xu, Xu, Qxua, Xu, Xu, Xu, Xu, Xu, Xu, Xu, Qxu, Uu^Emf, Uu, Uu, Isa^Em, Uu, Xu, Isa, Isa, Uu^Em, Uh^Em, Uh, Uh, Qxua, Xu, Xu, Xu, Xu, Uh, Uh^Emf, Uu, Isa^Edb, Xu, Xu, Xu, Xu, Xu, Xu, Xu, Xu, Xu
Xu, Xu, Xu, Xu, Xu, Xu, Xu, Xu, Xu, Xu, Xu, Xu, Qxua, Qxua, Qxua, Qxua, Isa, Uu, Uu, Uu, Qxu, Uu, Uu^Em, Uu^Emf, Xu, Qxua, Xu, Xu, Xu, Xu, Xu, Xu, Uh^Em, Uu^Edb, Isa^Edb, Xu, Xu, Xu, Xu, Xu, Xu, Xu, Xu, Xu
Xu, Xu, Xu, Xu, Xu, Xu, Xu, Xu, Qxua, Qxua, Qxua, Qxua, Xu, Xu, Xu, Isa, Uh, Isa, Uh^Em, Uu^Emf, Uu^Em, Qxu, Qxua, Qxua, Xu, Xu, Xu, Xu, Xu, Xu, Cud, Cud, Cud, Isa, Isa^Edb, Xu, Xu, Xu, Xu, Xu, Xu, Xu, Xu, Xu
Xu, Xu, Xu, Xu, Xu, Xu, Xu, Xu, Qxua, Uu, Qxua, Xu, Xu, Xu, Xu, Xu, Xu, Uh, Xu, Xu, Xu, Xu, Xu, Xu, Xu, Xu, Xu, Xu, Xu, Xu, Cud, Kud, Cud, Qxua, Isa, Uh^Edb, Uh, Uh, Xu, Xu, Xu, Xu, Xu, Xu
Xu, Xu, Xu, Xu, Xu, Xu, Xu, Xu, Xu, Qxua, Xu, Xu, Xu, Xu, Xu, Xu, Xu, Xu, Xu, Xu, Xu, Xu, Xu, Xu, Xu, Xu, Xu, Xu, Xu, Xu, Uh, Cud, Uh^Edb, Isa, Xu, Uh, Xu, Xu, Xu, Xu, Xu, Xu, Xu, Xu
Xu, Xu, Xu, Xu, Xu, Xu, Xu, Xu, Xu, Xu, Xu, Xu, Xu, Xu, Xu, Xu, Xu, Xu, Xu, Xu, Xu, Xu, Xu, Xu, Xu, Xu, Xu, Xu, Xu, Xu, Uh, Isa^Edb, Uu^Edb, Xu, Xu, Xu, Xu, Xu, Xu, Xu, Xu, Xu, Xu, Xu
Xu, Xu, Xu, Xu, Xu, Xu, Xu, Xu, Xu, Xu, Xu, Xu, Xu, Xu, Xu, Xu, Xu, Xu, Xu, Xu, Xu, Xu, Xu, Xu, Xu, Xu, Xu, Xu, Xu, Xu, Uh, Isa, Uu, Xu, Xu, Xu, Xu, Xu, Xu, Xu, Xu, Xu, Xu, Xu
