Xu, Xu, Xu, Xu, Xu, Xu, Xu, Xu, Xu, Xu, Xu, Xu, Xu, Xu, Xu, Xu, Xu, Xu, Xu, Xu, Xu, Xu, Xu, Xu, Xu, Xu, Xu, Xu, Xu, Xu, Xu
Xu, Xu, Xu, Xu, Xu, Xu, Xu, Xu, Xu, Xu, Xu, Xu, Uh, Uu, Uh^Emf, Xu, Uh, Xu, Uu^Edb, Ur^Edb, Ur^Edb, Xu, Uh, Xu, Xu, Xu, Xu, Xu, Xu, Xu, Xu
Xu, Xu, Xu, Xu, Xu, Xu, Xu, Xu, Xu, Xu, Xu, Uu, Xu, Uh^Em, Uu^Em, Ur^Edb, Ur^Edb, Ur^Ii, Uu, Uu^Edb, Uu, Uu^Edb, Uh, Cud, Cud^Ii, Xu, Xu, Xu, Xu, Xu, Xu
Wo, Xu, Xu, Xu, Xu, Xu, Xu, Xu, Xu, Xu, Xu, Uh, Uh^Ii, Uh, Uu, Uu, Xu, Uu, Xu, Xu, Ur, Uu^Ii, Ur, Cud, Cud, 2 Kud, Xu, Xu, Xu, Xu, Xu
Ww, Wo, Wwr, Xu, Xu, Xu, Xu, Xu, Xu, Xu, Xu, Uu^Edb, Uu^Edb, Ur^Ii, Uu^Vud, Xu, Uu^Vud, Xu, Ur, Ur, Uu^Ii, Ur^Ii, Xu, Uh, Uh, Cud^Es, Xu, Xu, Xu, Xu, Xu
Qxua, Ww, Uh, Uu, Xu, Xu, Xu, Xu, Xu, Xu, Xu, Xu, Uh, Ur, Uh, Xu, Xu, Ur^Edb, Uu^Em, Uu, Xu, Xu, Xu, Xu, Ur, Cud^Es, Xu, Xu, Xu, Xu, Xu
Xu, Qxua, Uh, Ur, Xu, Xu, Xu, Xu, Xu, Xu, Xu, Xu, Qxu, Qxu^Bs|, Qxu, Xu, Uh, Ur^Em, Uh^Emf, Uh^Em, Xu, Xu, Xu, Ur^Emf, Uu^Vud, Uh, Xu, Xu, Xu, Xu, Xu
Xu, Xu, Uu, Uu, Xu, Xu, Xu, Xu, Xu, Xu, Xu, Xu, Uu, Ur, Ur, Qxu, Qxu^Bs/, Ur, Xu, Xu, Xu, Xu, Ur^Em, Ur^Em, Uh, Uh, Xu, Xu, Xu, Xu, Xu
Xu, Xu, Uu, Ww, Xu, Xu, Xu, Xu, Xu, Xu, Wwr, Uh, Ur, Uh, Ur, Ur, Uh, Qxu, Xu, Xu, Xu, Ur, Uu, Uh, Xu, Xu, Xu, Xu, Xu, Xu, Xu
Xu, Xu, Uu, Uh, Qxua, Xu, Xu, Xu, Uh, Uh, Ur, Uu, Ur, Uh, Uu^Vud, Ur, Ur, Qxu, Ur, Uu^Vud, Uu^Ii, Ur, Uh, Uh, Xu, Xu, Xu, Xu, Xu, Xu, Xu
Qxua, Xu, Uh, Ur, Qxua, Xu, Xu, Uu^Vud, Ur, Uu, Uu, Ur, Uh, Uu, Xu, Uu, Xu, Qxu^Bs\, Ur, Uh^Edb, Uh, Uh^Ii, Xu, Xu, Xu, Xu, Xu, Xu, Xu, Xu, Xu
Wo, Qxua, Uu, Ur, Qxua, Qxua, Qxua, Qxua, Ur, Ww, Uu, Uu, Qxua, Xu, Xu, Xu, Qxu, Qxu, Uu, Uh, Xu, Xu, Xu, Xu, Xu, Xu, Xu, Xu, Xu, Xu, Xu
Uh, Uh, Uh, Uu, Ur, Ww, Uh, Uu, Ur, Uh, Ur, Qxua, Qxua, Xu, Xu, Xu, Xu, Xu, Xu, Xu, Xu, Xu, Xu, Xu, Xu, Xu, Xu, Xu, Xu, Xu, Xu
Wwr, Uu^Vud, Uh, Uh, Ur, Uu, Uh, Uu^Vud, Uh, Ur, Ww, Qxua, Xu, Xu, Xu, Xu, Xu, Xu, Xu, Xu, Xu, Xu, Xu, Xu, Xu, Xu, Xu, Xu, Xu, Xu, Xu
Uh, Uu, Ur, Ur, Xu, Ur, Wwr, Ur, Uh, Ur, Qxua, Qxua, Xu, Xu, Xu, Xu, Xu, Xu, Xu, Xu, Xu, Xu, Xu, Xu, Xu, Xu, Xu, Xu, Xu, Xu, Xu
Xu, Uh, Uu^Vud, Wwr, Xu, Uh, Uh, Uu, Ur, Ur, Uu, Uu, Uh, Uu^Vud, Ww, Xu, Wo, Ww, Xu, Xu, Xu, Xu, Xu, Xu, Xu, Xu, Xu, Xu, Xu, Xu, Xu
Xu, Xu, Xu, Xu, Ww, Uh, Ur, Ur, Uh, Uh, Uh, Ur, Ur, Ur, Uu, Wwr, Qxua, Uu, Uu, Xu, Xu, Xu, Xu, Xu, Xu, Xu, Xu, Xu, Xu, Xu, Xu
Xu, Xu, Xu, Xu, Xu, Uh, Ur, Uu, Uh, Uh, Qxua, Uu, Uu^Vud, Ww, Qxua, Qxua, Ww, Qxua, Uu, Ww, Xu, Xu, Ww, Xu, Uu, Xu, Xu, Xu, Xu, Xu, Xu
Xu, Xu, Xu, Xu, Xu, Uh, Uu, Uu, Uh, Qxua, Qxua, Qxua, Qxua, Qxua, Qxua, Qxua, Uu, Uu, Xu, Xu, Xu, Xu, Uu, Uu, Uu, Xu, Xu, Xu, Xu, Xu, Xu
Xu, Xu, Xu, Xu, Cud, Cud, Uu, Ur, Uh, Qxua, Qxua, Qxua, Qxua, Qxua, Qxua, Qxua, Uu, Xu, Xu, Uu, Ww, Uu, Qxua, Wo, Xu, Xu, Xu, Xu, Xu, Xu, Xu
Xu, Xu, Xu, Xu, 4 Kud, Uh, Uh, Ur, Uh, Uh, Uu^Vud, Qxua, Qxua, Qxua, Qxua, Ww, Ww, Xu, Uu, Wo, Qxua, Qxua, Wo, Ww, Uu, Uu, Wo, Xu, Xu, Xu, Xu
Xu, Xu, Xu, Ww, Cud, Uh, Uu, Ur, Uu, Ww, Qxua, Qxua, Qxua, Qxua, Ww, Uu, Uu, Uu, Uh, Uu, Qxua, Qxua, Ww, Qxua, Uu, Xu, Xu, Xu, Xu, Xu, Xu
Xu, Xu, Xu, Xu, Qxua, Cud, Uu, Ur, Uh, Uu, Uh, Qxua, Uu, Ur, Uh, Uu, Qxua, Qxua, Qxua, Qxua, Qxua, Qxua, Qxua, Qxua, Ww, Uu, Xu, Xu, Xu, Xu, Xu
Xu, Xu, Xu, Xu, Xu, Qxua, Qxua, Ur, Uu, Uu, Uu, Uu, Wwr, Uu, Xu, Uu, Uu, Ww, Ww, Qxua, Qxua, Qxua, Qxua, Uu, Wo, Ww, Xu, Xu, Xu, Xu, Xu
Xu, Xu, Xu, Xu, Xu, Xu, Qxua, Qxua, Ur, Ww, Uu, Uh, Xu, Xu, Xu, Xu, Xu, Xu, Xu, Ww, Qxua, Qxua, Qxua, Wwr, Wo, Uh, Ww, Xu, Xu, Xu, Wo
Xu, Xu, Xu, Xu, Xu, Xu, Ww, Uh, Uh, Ur, Uh, Xu, Xu, Xu, Xu, Xu, Xu, Xu, Xu, Wo, Wo, Wo, Ww, Qxua, Qxua, Uu, Ww^Vm, Uu, Ww, Xu, Wo
Xu, Xu, Uu, Uu, Ww, Uu, Uh, Uu, Ur, Ur, Uh, Xu, Xu, Xu, Xu, Xu, Xu, Xu, Xu, Xu, Xu, Xu, Xu, Ww, Uu, Uu, Xu, Ww, Chw, Chw, Chw
Wo, Ww, Uh, Uu, Uh, Uh, Xu, Uu, Ur, Uu, Uh, Xu, Xu, Xu, Xu, Xu, Xu, Xu, Xu, Xu, Xu, Xu, Xu, Xu, Xu, Xu, Ww^Vm, Uu, Chw, 3 Khw, Wo
Wo, Wwr, Xu, Xu, Xu, Xu, Wwr, Ur, Uu^Vu, Uu, Ww, Xu, Xu, Xu, Xu, Xu, Xu, Xu, Xu, Xu, Xu, Xu, Xu, Xu, Xu, Xu, Uh, Ww, Chw, Ww, Wo
Xu, Xu, Xu, Xu, Xu, Uu, Uu, Ur, Uh, Uu, Xu, Xu, Xu, Xu, Xu, Xu, Xu, Xu, Xu, Xu, Xu, Xu, Xu, Xu, Xu, Ww, Xu, Uu, Xu, Wo, Wo
Xu, Xu, Xu, Xu, Xu, Uu, Ur, Ur, Uh, Xu, Xu, Xu, Xu, Xu, Xu, Xu, Xu, Xu, Xu, Xu, Xu, Xu, Xu, Xu, Xu, Wo, Xu, Xu, Xu, Xu, Xu
Xu, Xu, Xu, Xu, Xu, Cud, Cud, Cud, Xu, Xu, Xu, Xu, Xu, Xu, Xu, Xu, Xu, Xu, Xu, Xu, Xu, Xu, Xu, Xu, Xu, Xu, Xu, Xu, Xu, Xu, Xu
Xu, Xu, Xu, Xu, Cud, Cud, Cud, Xu, Xu, Xu, Xu, Xu, Xu, Xu, Xu, Xu, Xu, Xu, Xu, Xu, Xu, Xu, Xu, Xu, Xu, Xu, Xu, Xu, Xu, Xu, Xu
Xu, Xu, Xu, Xu, Ww, 1 Kud, Ww, Xu, Xu, Xu, Xu, Xu, Xu, Xu, Xu, Xu, Xu, Xu, Xu, Xu, Xu, Xu, Xu, Xu, Xu, Xu, Xu, Xu, Xu, Xu, Xu
Xu, Xu, Ww, Ww, Ww, Ww, Xu, Xu, Xu, Xu, Xu, Xu, Xu, Xu, Xu, Xu, Xu, Xu, Xu, Xu, Xu, Xu, Xu, Xu, Xu, Xu, Xu, Xu, Xu, Xu, Xu
