Xu, Xu, Xu, Xu, Xu, Xu, Xu, Xu, Xu, Xu, Xu, Xu, Xu, Xu, Xu, Xu, Xu, Xu, Xu, Xu, Xu, Xu, Xu, Xu, Xu, Xu, Xu, Xu, Xu, Xu, Xu
Xu, Xu, Xu, Xu, Xu, Xu, Xu, Xu, Xu, Xu, Xu, Xu, Uh, Uu, Uh^Emf, Xu, Uh, Xu, Uu^Edb, Ur^Edb, Ur^Edb, Xu, Uh, Xu, Xu, Xu, Xu, Xu, Xu, Xu, Xu
Xu, Xu, Xu, Xu, Xu, Xu, Xu, Xu, Xu, Xu, Xu, Uu, Xu, Uh^Em, Uu^Em, Ur^Edb, Ur^Edb, Ur^Ii, Uu, Uu^Edb, Uu, Uu^Edb, Uh, Cud, Cud^Ii, Xu, Xu, Xu, Xu, Xu, Xu
Xu, Xu, Xu, Xu, Xu, Xu, Xu, Xu, Xu, Xu, Xu, Uh, Uh^Ii, Uh, Uu, Uu, Xu, Uu, Xu, Xu, Ur, Uu^Ii, Ur, Cud, Cud, 2 Kud, Xu, Xu, Xu, Xu, Xu
Xu, Xu, Xu, Xu, Xu, Xu, Xu, Xu, Xu, Xu, Xu, Uu^Edb, Uu^Edb, Ur^Ii, Uu^Vud, Xu, Uu^Vud, Xu, Ur, Ur, Uu^Ii, Ur^Ii, Xu, Uh, Uh, Cud^Es, Xu, Xu, Xu, Xu, Xu
Xu, Xu, Xu, Xu, Xu, Xu, Xu, Xu, Xu, Xu, Xu, Xu, Uh, Ur, Uh, Xu, Xu, Ur^Edb, Uu^Em, Uu, Xu, Xu, Xu, Xu, Ur, Cud^Es, Xu, Xu, Xu, Xu, Xu
Xu, Xu, Xu, Xu, Xu, Xu, Xu, Xu, Xu, Xu, Xu, Xu, Qxu, Qxu^Bs|, Qxu, Xu, Uh, Ur^Em, Uh^Emf, Uh^Em, Xu, Xu, Xu, Ur^Emf, Uu^Vud, Uh, Xu, Xu, Xu, Xu, Xu
Xu, Xu, Xu, Xu, Xu, Xu, Xu, Xu, Xu, Xu, Xu, Xu, Uu, Ur, Ur, Qxu, Qxu^Bs/, Ur, Xu, Xu, Xu, Xu, Ur^Em, Ur^Em, Uh, Uh, Xu, Xu, Xu, Xu, Xu
Xu, Xu, Xu, Xu, Xu, Xu, Xu, Xu, Xu, Xu, Ww, Uh, Ur, Uh, Ur, Ur, Uh, Qxu, Xu, Xu, Xu, Ur, Uu, Uh, Xu, Xu, Xu, Xu, Xu, Xu, Xu
Xu, Xu, Xu, Xu, Xu, Xu, Xu, Xu, Uh, Uh, Ur, Uu, Ur, Uh, Uu^Vud, Ur, Ur, Qxu, Ur, Uu^Vud, Uu^Ii, Ur, Uh, Uh, Xu, Xu, Xu, Xu, Xu, Xu, Xu
Xu, Xu, Xu, Xu, Xu, Xu, Xu, Uu^Vud, Ur, Uu, Uu, Ur, Uh, Uu, Xu, Uu, Xu, Qxu^Bs\, Ur, Uh^Edb, Uh, Uh^Ii, Xu, Xu, Xu, Xu, Xu, Xu, Xu, Xu, Xu
Wo, Xu, Xu, Xu, Xu, Xu, Xu, Xu, Ur, Ww, Uu, Uu, Xu, Xu, Xu, Xu, Qxu, Qxu, Uu, Uh, Xu, Xu, Xu, Xu, Xu, Xu, Xu, Xu, Xu, Xu, Xu
Wo, Ww, Uh, Xu, Uh, Ww, Uh, Uu, Ur, Uh, Ur, Uh, Xu, Xu, Xu, Xu, Xu, Xu, Xu, Xu, Xu, Xu, Xu, Xu, Xu, Xu, Xu, Xu, Xu, Xu, Xu
Ww, Uu^Vud, Uh, Uh, Ur, Uu, Uh, Uu^Vud, Uh, Ur, Ww, Xu, Xu, Xu, Xu, Xu, Xu, Xu, Xu, Xu, Xu, Xu, Xu, Xu, Xu, Xu, Xu, Xu, Xu, Xu, Xu
Uh, Uu, Ur, Ur, Xu, Ur, Wwr, Uh, Uh, Ur, Xu, Xu, Xu, Xu, Xu, Xu, Xu, Xu, Xu, Xu, Xu, Xu, Xu, Xu, Xu, Xu, Xu, Xu, Xu, Xu, Xu
Xu, Uh, Uu^Vud, Wwr, Xu, Uh, Uh, Uu, Ur, Ur, Uu, Uu, Uh, Uu^Vud, Ww, Xu, Wo, Ww, Xu, Xu, Xu, Xu, Xu, Xu, Xu, Xu, Xu, Xu, Xu, Xu, Xu
Xu, Xu, Xu, Xu, Ww, Uh, Uu, Ur, Uh, Qxua, Qxua, Ur, Ur, Ur, Uu, Wo, Qxua, Uu, Uu, Xu, Xu, Xu, Xu, Xu, Xu, Xu, Xu, Xu, Xu, Xu, Xu
Xu, Xu, Xu, Xu, Xu, Uh, Uu, Uu, Uh, Uh, Qxua, Uu, Uu^Vud, Ww, Qxua, Qxua, Ww, Qxua, Uu, Ww, Xu, Xu, Ww, Xu, Uu, Xu, Xu, Xu, Xu, Xu, Xu
Xu, Xu, Xu, Xu, Xu, Uh, Uu, Uu, Uh, Qxua, Qxua, Qxua, Qxua, Qxua, Qxua, Qxua, Uu, Uu, Xu, Xu, Xu, Xu, Uu, Uu, Uu, Xu, Xu, Xu, Xu, Xu, Xu
Xu, Xu, Xu, Xu, Cud, Cud, Uu, Ur, Uh, Qxua, Qxua, Qxua, Qxua, Qxua, Qxua, Qxua, Uu, Xu, Xu, Uu, Ww, Uu, Qxua, Wo, Xu, Xu, Xu, Xu, Xu, Xu, Xu
Xu, Xu, Xu, Xu, 4 Kud, Uh, Uh, Ur, Uh, Uh, Uu^Vud, Qxua, Qxua, Qxua, Qxua, Wo, Ww, Xu, Uu, Wo, Qxua, Qxua, Wo, Ww, Uu, Uu, Wo, Xu, Xu, Xu, Xu
Xu, Xu, Xu, Ww, Cud, Uh, Uu, Ur, Uu, Ww, Qxua, Qxua, Qxua, Qxua, Uu, Uu, Wo, Uu, Uh, Uu, Qxua, Qxua, Ww, Qxua, Uu, Xu, Xu, Xu, Xu, Xu, Xu
Xu, Xu, Xu, Xu, Xu, Cud, Uu, Uh, Uh, Uu, Uh, Qxua, Uu, Ww, Uh, Uu, Qxua, Qxua, Qxua, Qxua, Qxua, Qxua, Qxua, Qxua, Wo, Uu, Xu, Xu, Xu, Xu, Xu
Xu, Xu, Xu, Xu, Xu, Xu, Xu, Ur, Uu, Uu, Uu, Uu, Wo, Uu, Xu, Uu, Wo, Wo, Wo, Qxua, Qxua, Qxua, Qxua, Uu, Wo, Wo, Xu, Xu, Xu, Xu, Xu
Xu, Xu, Xu, Xu, Xu, Xu, Xu, Ur, Ur, Ww, Uu, Uh, Xu, Xu, Xu, Xu, Xu, Xu, Xu, Wo, Qxua, Qxua, Qxua, Wwr, Wo, Uh, Ww, Xu, Xu, Xu, Wo
Xu, Xu, Xu, Xu, Xu, Xu, Wo, Uh, Uh, Ur, Uh, Xu, Xu, Xu, Xu, Xu, Xu, Xu, Xu, Wo, Wo, Wo, Wo, Qxua, Qxua, Uu, Ww^Vm, Uu, Ww, Xu, Wo
Xu, Xu, Uu, Uu, Ww, Uu, Xu, Uu, Ur, Ur, Uh, Xu, Xu, Xu, Xu, Xu, Xu, Xu, Xu, Xu, Xu, Xu, Xu, Wo, Uu, Uu, Xu, Ww, Chw, Chw, Chw
Wo, Wo, Uh, Uu, Xu, Xu, Uh, Uu, Uu, Uu, Uh, Xu, Xu, Xu, Xu, Xu, Xu, Xu, Xu, Xu, Xu, Xu, Xu, Xu, Xu, Xu, Ww^Vm, Uu, Chw, 3 Khw, Wo
Wo, Ww, Xu, Xu, Xu, Uh, Ww, Ur, Uu^Vu, Uu, Wo, Xu, Xu, Xu, Xu, Xu, Xu, Xu, Xu, Xu, Xu, Xu, Xu, Xu, Xu, Xu, Uh, Ww, Chw, Wo, Wo
Xu, Xu, Xu, Xu, Xu, Uu, Uu, Ur, Uh, Ww, Xu, Xu, Xu, Xu, Xu, Xu, Xu, Xu, Xu, Xu, Xu, Xu, Xu, Xu, Xu, Ww, Xu, Uu, Xu, Wo, Wo
Xu, Xu, Xu, Xu, Xu, Uu, Ur, Ur, Uh, Xu, Xu, Xu, Xu, Xu, Xu, Xu, Xu, Xu, Xu, Xu, Xu, Xu, Xu, Xu, Xu, Wo, Xu, Xu, Xu, Xu, Xu
Xu, Xu, Xu, Xu, Xu, Cud, Cud, Cud, Xu, Xu, Xu, Xu, Xu, Xu, Xu, Xu, Xu, Xu, Xu, Xu, Xu, Xu, Xu, Xu, Xu, Xu, Xu, Xu, Xu, Xu, Xu
Xu, Xu, Xu, Xu, Cud, Cud, Cud, Uu, Xu, Xu, Xu, Xu, Xu, Xu, Xu, Xu, Xu, Xu, Xu, Xu, Xu, Xu, Xu, Xu, Xu, Xu, Xu, Xu, Xu, Xu, Xu
Xu, Xu, Xu, Xu, Ww, 1 Kud, Ww, Uu, Xu, Xu, Xu, Xu, Xu, Xu, Xu, Xu, Xu, Xu, Xu, Xu, Xu, Xu, Xu, Xu, Xu, Xu, Xu, Xu, Xu, Xu, Xu
Xu, Xu, Ww, Ww, Ww, Ww, Uu, Uu, Xu, Xu, Xu, Xu, Xu, Xu, Xu, Xu, Xu, Xu, Xu, Xu, Xu, Xu, Xu, Xu, Xu, Xu, Xu, Xu, Xu, Xu, Xu
