Ms, Ms, Ms, Re, Re, Gd, Aa^Esa, Aa, Aa, Gll, Aa^Fma, Gd, Ha, Ha, Ha, Md, Md^Xm, Md, Md, Md, Md^Xm, Md, Md, Md^Xm, Md, Ms, Ms, Ms, Md^Xm, Md, Md, Md, Md, Md, Md, Md, Md^Xm, Md, Md, Md^Xm, Md^Xm, Md, Md, Md, Md, Md, Md^Xm, Md
Ha, Ms, Ai, Ms, Aa^Feta, Re^Esa, Re^Es, Aa^Esa, Aa^Fma, Gd, Aa, Aa^Fma, Gd^Em, Gd^Esa, Ha^Fdw, Md, Md, Md^Xm, Md, Md, Md, Md^Xm, Md, Md, Ms, Ms, Md, Md^Xm, Md, Md, Md, Md^Xm, Md^Xm, Md, Md, Md, Md, Md^Xm, Md, Md, Md, Md, Md, Md, Md, Md, Md, Md
Md, Ai, Hhd^Em, Ai, Ai, Ai, Aa, Re, Re, Gd^Efm, Ce, Aa, Aa^Esa, Hhd^Fdf, Ha, Ha^Esa, Ha^Esa, Md, Md, Md, Md, Md, Md, Md, Ms, Md, Md, Md, Md, Md, Md^Xm, Md, Md, Md, Md, Md, Md^Xm, Md, Md, Md, Ms, Md, Ms, Ms, Md, Md, Md, Md
Ms, Md, Md, Ha^Fda, Ha^Fda, Aa^Fda, Rra, Rra, Rra, Ce, 3 Ke, Ce, Wwg, Aa, Rra, Rra^Esa, Rra^Esa, Ha, Md^Xm, Md, Md, Md^Xm, Md^Xm, Ms, Md, Md^Xm, Md^Xm, Md, Md, Md, Md, Md^Xm, Md, Md, Ms, Md, Md, Md, Ms, Md, Md, Ms, Hhd^Fdf, Ms, Ms, Md, Md, Md
Ms, Ms, Ms, Ms, Md^Xm, Hhd, Ms, Hhd, Gd, Cea, Cea, Cea^Esa, Gll, Aa, Aa^Fma, Aa, Rra, Md, Md, Md^Xm, Md, Md, Md, Md, Md, Md, Md, Md, Md, Md, Md, Md, Md, Md, Md, Ms, Md^Xm, Ms, Ms, Hhd, Hhd^Fdw, Md, Hhd, Ms, Md^Xm, Ms, Ms, Md
Ms, Ms, Md, Md, Md, Md^Xm, Md, Hhd^Fdw, Gll, Gll^Ecf, Gll, Gll^Esa, Gd, Ce, Aa^Fma, Aa, Aa, Hhd^Em, Hhd^Vhhr, Md, Md, Md, Ha^Fdw, Md, Md, Md^Xm, Md, Md, Md^Xm, Md, Md, Md, Md, Md, Md, Md^Xm, Md, Md, Gd^Esa, Hhd, Gll^Esa, Hhd^Fdf, Gll^Fetd, Md, Md, Md^Xm, Md, Ms
Ms, Ms, Md^Xm, Md, Md, Md, Md, Md, Gd^Vea, Ce, Cea, Ce, Gd, Gd^Efm, Gd^Efm, Aa^Fma, Gll, Hhd, Aa, Ha, Ha^Fma, Ha^Fdw, Rra, Hhd^Emf, Hhd^Em, Md, Md, Md, Md, Md^Xm, Md, Md, Md, Md, Md, Md, Rra, Ms, Aa^Voa, Gd^Esa, Rb, Gll^Esa, Ms, Ms, Md^Xm, Md, Md, Md
Ms, Md, Md, Md^Xm, Md, Ms, Ms, Ms, Aa^Fdw, Gd, Gll^Esa, Gll^Esa, Gll^Esa, Aa, Gd^Es, Gd^Efm, Re, Ai, Ai, Ha, Hhd, Rra, Wwg, Rra, Hhd^Fdw, Hhd^Fdw, Hhd, Md, Md, Md, Md, Md, Md^Xm, Md^Xm, Md, Ms, Hhd^Esa, Rra, Rb, Rb, Ms, Ms, Md, Md^Xm, Md, Md, Ms, Md
Md, Md^Xm, Md^Xm, Md, Md, Md, Ha, Ha, Aa^Fdw, Gll, Wwf, Wwf^Ewl, Sm, Aa, Gd^Esa, Aa^Voa, Re, Aa^Fma, Ai, Hhd, Ai, Ai, Aa, Wwrg, Hhd^Fdf, Ha, Gd, Ha, Ha, Ms, Md, Md, Md, Md, Ms, Ms, Aa^Fma, Rra^Esa, Rb, Hhd, Md, Md, Md, Md, Hhd^Fdw, Hhd^Em, Rra, Hhd
Md, Md, Md, Md, Md, Ms, Ms, Aa^Fdw, Gd^Fdf, Wwrg, Hhd^Fdf, Wog, Wog, Aa^Esa, Aa^Feta, Re, Aa^Fma, Aa^Fma, Aa, Aa^Esa, Aa, Ai, Ai, Wog, Gll, Gll, Aa, Aa, Ha, Ms, Ms, Md, Hhd^Fdf, Hhd^Fdf, Hhd^Esa, Hhd, Aa^Fma, Aa^Esa, Rb^Es, Hhd^Fdw, Ha^Fdw, Md, Md, Ms, Hhd^Fdf, Ai, Ai, Rra
Md, Md^Xm, Md, Md, Md, Md^Xm, Md^Xm, Ms, Ms, Wwg^Ewl, Hhd, Hhd^Em, Wwrg, Rb, Rb, Aa, Ai, Aa, Re, Re^Esa, Re^Esa, Aa, Aa^Esa, Wog, Wwg, Wwg^Ewl, Gd, Aa, Ha^Fdw, Ms, Hhd^Fdw, Hhd, Rb^Fdw, Gll^Fdw, Gd^Fetd, Aa^Fma, Aa, Aa, Rb, Rb^Es, Ai, Ha, Hhd, Hhd^Fma, Ai, Ai, Rra^Es, Rra
Ms, Md, Md, Md^Xm, Md^Xm, Md, Md, Md, Md, Ms, Ha^Fdw, Hhd^Fdw, Rb, Wwg^Es, Rb^Esa, Aa, Ai, Gd, Gd^Es, Gd^Esa, Gll, Re, Re, Gd^Esa, Gd^Efm, Gd^Efm, Gd^Ve, Aa, Aa, Ha, Gll^Esa, Gll^Esa, Rb, Rb, Gd, Aa, Re, Re^Es, Re^Es, Ai, Re, Ai, Ai, Ai, Rra, Rra^Es, Aa, Aa
Ms, Md, Md, Md, Md, Md, Md, Md, Ms, Ms, Ha^Fdw, Hhd, Aa^Fpa, Rb^Es, Ai^Esa, Aa^Esa, Ai, Aa^Fma, Aa, Gd^Efm, Aa^Vla, Gll^Es, Re^Es, Re^Es, Re^Es, Aa, Gd^Efm, Aa, Gd^Efm, Aa, Gd, Rb, Wwg^Ewl, Wwg, Re, Re, Gd, Rb^Wm, Gd, Re^Es, Wwg, Re^Esa, Re, Re^Esa, Aa^Fma, Aa, Aa, Gd
Md, Md^Xm, Md^Xm, Md, Md, Md, Md^Xm, Ms, Ms, Md, Md, Ha^Fdw, Aa, Ai, Aa^Fma, Ai, Gll^Esa, Rra, Rra, Aa, Gd^Efm, Gll, Wwf, Gll, Re, Aa^Fma, Gd^Edt, Gd^Edt, Gd^Em, Gd^Em, Gd^Em, Aa, Re^Esa, Ai, Gd^Efm, Gd^Efm, Gll^Vhc, Gll, Gll^Esa, Gd^Esa, Aa, Wwg^Ewl, Wog, Re^Esa, Aa, Aa, Gd, Gd
Ms, Md, Md, Md, Md, Md, Md, Md^Xm, Md, Ms, Md, Md, Ms, Gll, Aa^Fma, Gd, Gll^Es, Gll, Rra, Aa, Gd^Edt, Wwf, Cea, Wwrg, Wog, Re^Esa, Ai, Ai, Ai, Aa, Ai, Re, Gd^Esa, Aa, Aa, Aa, Aa^Fma, Gll, Gd, Gd, Gd^Efm, Wwg, Gll, Wog, Aa^Esa, Aa, Re^Vea, Aa^Fma
Md, Md^Xm, Md^Xm, Md, Ms, Md, Md^Xm, Md, Md, Md, Ms, Md, Md, Gll, Aa^Fma, Gd^Es, Rra^Es, Rra, Gd^Fdw, Gd^Fdw, Gd^Edt, Cea^Edt, 1 Kea, Cea, Wwg, Ai, Ms, Ms, Ms, Ai, Ha, Gd^Esa, Ha, Ai, Ai, Aa^Esa, Aa^Fma, Aa, Aa, Gd^Efm, Aa, Wwg^Bw\r, Rra, Rra, Rra, Gd^Efm, Re, Aa^Fma
Md, Md, Md, Md, Md, Md, Md, Md, Ms, Ms, Aa, Ms, Aa, Gll, Aa^Fma, Gd^Edt, Gd^Edt, Aa^Fma, Gd, Rb^Ecf, Gd, Cea^Edt, Cea^Edt, Cea, Gd^Edt, Ha^Fdw, Ms, Md, Md, Ms, Md, Ha, Ms, Ha^Fdf, Ai, Aa^Esa, Aa^Fda, Aa^Fma, Aa^Feta, Aa, Wwg^Ewl, Wwg^Ewl, Ce, Ce, Ce, Gd^Efm, Gll, Re
Md, Md^Xm, Md, Md, Ms, Md, Md, Ms, Ms, Ha^Fda, Aa^Fda, Gll^Fetd, Gd^Efm, Aa^Fma, Aa, Aa^Esa, Wwg^Ewl, Gd^Efm, Wog, Gd^Esa, Gll^Fdw, Gd^Fdw, Gll^Fdw, Ai, Ai, Ha^Fmw, Md, Md^Xm, Md^Xm, Md, Md, Ms, Ms, Ha^Fdw, Ai, Aa^Fda, Gd^Efm, Gd^Es, Wog, Wwg, Cea, Aa, Rrc^Vhca, Gll, Gll, Gll, Ai, Ai
Md, Md, Md, Ms, Ha, Ms, Ms, Md, Ms, Ha, Gll, Gd^Vhr, Aa, Aa, Rra, Wog, Aa, Aa, Aa^Esa, Wwrg, Ha, Aa^Vea, Hhd, Hhd^Fdf, Hhd^Fdf, Ai, Ha, Md, Md, Md, Md, Md, Md, Hhd^Emf, Aa, Gll, Gd^Efm, Aa^Fma, Wwg, Rb, Rb, Aa, Ce, Ce, Cea, Gd^Ecf, Ai, Aa^Fdw
Md, Md, Ms, Ha, Rra, Ha, Rra^Fda, Aa^Fda, Aa, Ms, Gll, Aa, Rb, Rra, Ai, Rra, Rra, Gd^Esa, Aa^Fma, Wwg, Aa, Ha, Ms, Ms, Md, Md, Md, Ms, Ms, Md, Md, Md^Xm, Md, Hhd^Fma, Hhd^Fma, Aa, Aa^Fda, Gll^Efm, Wwf, Aa, Rb^Es, Re^Es, Ce, 2 Ke, Cea, Ai, Aa, Aa
Ha, Ms, Ha, Ms, Rra, Rra^Esa, Ai, Ai, Ce, Aa^Esa, Gd, Aa^Fda, Rb^Es, Gll^Es, Ai, Ai, Ai, Rra^Esa, Hhd^Fdf, Aa^Fma, Ms, Ms, Md, Md^Xm, Md^Xm, Md, Md, Md, Ms, Md, Md, Md, Ms, Ms, Hhd^Em, Aa, Gd, Gll, Ai, Aa^Fma, Rb, Re, Rra, Cea, Gd, Ai, Aa^Fma, Gd
Aa, Ha, Aa, Rra, Aa^Fda, Ai, Cea, Rra, Rb^Ecf, Ce, Aa^Fma, Aa, Rb, Ai, Hhd^Em, Hhd^Emf, Hhd^Em, Hhd^Em, Md^Xm, Ms, Md, Md^Xm, Md, Md, Md, Md, Md, Ms, Md, Md^Xm, Md, Md, Md, Ms, Ms, Aa, Gd^Efm, Ai, Aa, Aa^Fma, Aa, Gll^Esa, Gll^Esa, Rra, Rra^Es, Gd^Vea, Gd^Efm, Gd^Efm
Aa, Gd^Fetd, Re, Aa, Re^Esa, Ce, 4 Ke, Cea, Rb^Es, Cea, Wwg^Ewl, Aa^Fma, Wwrg, Ai, Md^Xm, Ha, Ms, Md, Md, Md^Xm, Md, Md, Md, Md, Ms, Md, Md^Xm, Md, Md, Md, Md, Md, Md, Md, Md, Gll, Gll, Ai, Ai, Aa, Ai^Esa, Aa, Wwrg, Wog, Wog, Rra^Es, Rra, Gd
Aa, Gd^Efm, Re, Gll^Ve, Rra, Ce^Esa, Ce, Cea^Es, Ai, Rra, Rra, Wog, Ha^Vhha, Md, Md, Md^Xm, Md, Ms, Ms, Md, Md, Md, Md, Md^Xm, Md^Xm, Md, Md, Md^Xm, Md, Md, Md, Md, Md^Xm, Md^Xm, Md, Ha^Fma, Ha^Fda, Gll^Fetd, Aa^Fma, Ai, Rra, Wwg^Ewl, Aa^Fma, Aa^Esa, Aa^Esa, Wwg, Aa, Rra
Rb, Aa^Fda, Re, Rra, Ai, Ai, Ai, Ai, Aa, Ce^Em, Aa, Ha^Fma, Ms, Md, Md, Md, Md, Md, Md, Md, Md, Ms, Md, Md, Md, Md, Md, Md, Md, Md, Md, Md, Md, Md, Md^Xm, Ms, Ms, Ha^Fda, Ha, Aa^Fma, Rra, Aa^Fma, Aa^Fma, Aa, Aa^Fma, Aa, Wog, Wwg
Ms, Rb, Re, Aa^Fma, Ai, Aa^Fda, Aa^Fda, Aa^Fma, Md, Aa, Md, Ha, Ms, Ms, Ms, Md, Ms, Md, Ms, Md, Md, Md, Md, Md, Md, Md, Md, Md, Md, Md, Md, Md, Md, Md, Md, Md, Ms, Ms, Ha, Aa, Rra, Gd^Efm, Gd^Efm, Aa^Fma, Gd, Wwrg, Ms, Ms
