Ha, Ha, Ha, Ha, Ha, Ha, Ha^Esa, Ms, Ms, Ms, Ms, Ms, Ms, Ms, Ms, Ms, Ms, Ms, Ms, Wwf, Wwf^Ewl, Gd, Gd^Fdw, Gll, Gll, Gll, Wwf, Gd, Gd, Gd, Gll^Fdw, Gll, Aa^Fma, Ms, Ms, Ms, Ms, Ms^Xm, Ms, Ms, Ms, Ms
Wwg, Wwg, Gd^Fdw, Gd^Esa, Wog, Wwf, Gll^Fdw, Ha, Ms, Ms, Ha, Ms, Ms, Ms, Ms, Ms, Ha, Ha, Ha, Wwf, Ha, Wwf, Ha, Gd^Efm, Gd^Fdw, Gll^Fdw, Gll^Esa, Wwf^Ewl, Wwf^Es, Gd^Efm, Gd^Efm, Gll, Aa^Fma, Ms, Aa^Fma, Ms, Ms, Ms, Aa^Fma, Ms, Ms, Ms
Gll^Fdw, Wwg^Ewl, Gd, Ms, Gd^Fdw, Wwg, Gd^Es, Ms, Gd^Fdw, Ha, Ms, Ms^Xm, Ms, Aa^Feta, Ms, Ms^Xm, Ms, Md, Md, Ha, Gll^Fdw, Ha, Aa^Voa, Co, 3 Ko, Co^Edt, Aa^Voa, Gll^Esa, Wwg, Wog, Wog, Gd^Fdw, Aa, Aa^Fma, Gd^Fdw, Aa^Fma, Gd^Fdw, Aa^Fma, Aa, Aa^Fma, Aa^Fma, Ms
Gd^Fdw, Wwg^Ewl, Gll^Fdw, Gll^Fdw, Gll^Edt, Gd^Edt, Rr, Ms, Gd^Gvs, Gd^Fdw, Gd^Esa, Ms, Gll^Fdw, Gll^Fetd, Ms, Ms, Ms, Ms, Ms, Md, Gd^Fdf, Gll^Fdw, Co, Co, Co^Edt, Co^Edt, Co, Gll^Fdw, Rr, Wwg, Wog, Gll, Gd^Fdw, Gd^Fmw, Gd, Gd^Fdw, Gd, Gd, Gd^Efm, Aa^Esa, Gd^Efm, Ms
Gd^Fdw, Wwg, Gd^Fdw, Wwg, Gll^Fdw, Gd, Rr, Gd^Gvs, Gd^Gvs, Gd, Co, Aa^Voa, Rr, Rr, Gd^Gvs, Gd^Gvs, Gd^Gvs, Ms, Gd^Fdf, Md, Gd^Fdf, Gd^Fdw, Rr, Co, Gd^Gvs, Co, Gd^Gvs, Gd^Gvs, Rr, Wog, Wwg, Gll, Hhd, Hhd, Wog, Gd^Es, Aa^Voa, Gll^Esa, Gll^Fdw, Gll^Efm, Gd, Gd^Efm
Gll, Gll^Esa, Gll, Wwg, Gll^Esa, Wog, Rr, Gd^Gvs, Wog, Co, 5 Ko, Co, Gd^Gvs, Wog, Wwg, Gd^Gvs, Rr, Rr, Gll^Fdw, Gll^Fdw, Rr, Rr, Gd^Gvs, Gd^Gvs, Wog, Gd^Gvs, Gd^Gvs, Gd^Gvs, Rr, Gll^Fdw, Wwg^Ewl, Gll^Es, Gd, Hhd, Gd^Fdw, Gd^Fdw, Rb, Rb^Fdw, Chw, Gll^Fdw, Gd^Fdw, Gd
Wwg, Wwg, Wwg, Wwrg, Wwg, Gll^Fdw, Rr^Esa, Wog, Co, Co^Edt, Co^Edt, Co^Edt, Co, Gd^Gvs, Wog, Rr, Gd^Esa, Gll, Gd^Efm, Gd^Efm, Wwg, Gd^Gvs, Wog, Gd^Gvs, Gd^Gvs, Gd^Gvs, Wog, Rr, Wog, Gd^Edt, Gll^Edt, Wwg^Ewl, Gll, Hhd^Fdw, Hhd, Rb, Wwf, Wwf, Khw, Gll^Fdw, Gd^Edt, Gd^Fdw
Gll^Efm, Gll, Gll^Fdw, Gll^Fdw, Gll^Fdw, Wwg, Wog, Rr, Gd, Gd^Fdw, Gd^Fdw, Gd, Gd^Gvs, Gd^Gvs, Rr, Gd^Ecf, Gd^Efm, Gd^Fdw, Gd^Fdw, Gd^Gvs, Md, Wwg, Md, Wog, Wog, Wwg, Aa^Fma, Wog, Wog, Gd^Ecf, Gll^Es, Wwg^Ewl, Wog, Gll^Fdw, Wwf^Ewl, Rb^Fdw, Rb, Chw, Wwf, Chw, Gd^Efm, Gd^Fdw
Gd, Gd^Efm, Gll^Efm, Gll, Wog, Wog, Gll, Gd^Efm, Gd, Wog, Wwg, Wog, Gd^Gvs, Gd^Gvs, Rr, Gd^Edb, Gll^Fdw, Wog, Gd^Edt, Gd^Gvs, Ms, Md, Ms, Ms^Xm, Ms, Hhd, Gd^Fdf, Hhd^Dr, Gd, Gll^Fdw, Aa^Voa, Gll, Gd^Gvs, Wog, Wog, Wog, Wog, Wwg, Gll, Gd^Vhhr, Gd^Efm, Gd^Fdw
Gd^Fdw, Md, Gd^Fdf, Wog, Wwf, Wwf^Es, Wwf^Es, Gll^Efm, Md, Gd^Fdw, Md, Gd^Gvs, Wwg, Rr^Esa, Gd^Esa, Aa^Voa, Wwg, Gll^Edt, Wwf, Gd, Aa^Voa, Ms, Gd^Fdf, Ms, Ms, Ms, Gd^Fdf, Gd^Fdw, Rr, Gd, Gd^Gvs, Gd^Gvs, Co, Gd^Gvs, Gd^Gvs, Gll^Esa, Gll, Wwrg, Wwf, Gll^Efm, Gll^Fdw, Gd
Gd, Md, Gll^Esa, Gll^Esa, Wwf^Wkf, Wog, Wwf, Wog, Md, Md, Wwg, Md, Md, Md, Gll^Esa, Gll^Fdw, Wog, Wwf, Gll^Fdw, Wog, Wwg, Wwf, Gll, Gd^Fdw, Gll^Fdw, Gd^Fmf, Rr, Rr, Gd^Gvs, Aa^Esa, Aa, Co, 4 Ko, Co, Gd^Gvs, Wog, Rr, Gll^Fetd, Gll^Fdw, Wwf^Es, Wwf^Wkf, Gll
Gd^Fdw, Gd^Fdf, Gll^Esa, Wwf^Wkf, Wwf, Wwf, Wwg, Wwf, Wwg, Wwg, Wwg, Wwg, Wwf, Wwg, Wwf^Ewl, Wwf^Wkf, Wwf^Wkf, Wwf^Wkf, Md, Gll^Em, Md, Wwg, Wog, Gll^Esa, Wwf, Gll^Esa, Rr, Gd^Gvs, Gd^Gvs, Aa^Fma, Aa^Fma, Co, Co^Edt, Co^Edt, Gd^Gvs, Gd^Gvs, Rr, Ms, Gll, Gll^Edt, Wwf, Gll
Gll, Gll^Esa, Wwf^Wkf, Wwf^Wkf, Wwf^Ewl, Wog, Wwg, Wwf^Wkf, Hhd, Hhd, Hhd^Fdf, Hhd^Fdf, Hhd^Fdf, Wwf, Hhd, Hhd, Hhd^Em, Hhd^Emf, Md, Md, Md, Md, Hhd^Fdf, Wog, Wwf, Gll, Wwf, Gd^Em, Gd, Wwg, Aa^Fma, Co^Edt, Co, Co, Gd^Gvs, Gd^Gvs, Rr, Gd^Fdw, Rb, Rb^Edt, Gll^Fdw, Wwg
Wwg, Gll^Fdw, Gll, Wwf^Ewl, Wog, Wog, Wog, Wwf, Hhd, Ms, Ms, Ms^Xm, Ms, Ms, Ms, Md, Md, Md, Md, Md, Hhd^Fdf, Md, Md, Wwf, Wwf, Gll^Esa, Aa^Fma, Aa^Fma, Gd^Esa, Wog, Wog, Aa^Fma, Gd^Gvs, Gd^Gvs, Aa^Voa, Rr, Gd^Fdw, Gd^Fdw, Gd^Efm, Rb, Gll^Es, Wwg
Wwg, Wwg, Wwf, Wwf^Ewl, Wwf^Es, Wwf, Wwf, Wwf, Hhd, Ms, Aa^Fma, Ms, Aa^Fma, Ms, Ms, Ms, Ms, Ms, Hhd^Fdf, Hhd^Fmf, Gll^Vha, Hhd^Fdf, Gll^Fdf, Wwf, Hhd^Em, Wwg, Aa, Gd^Fdw, Gd^Es, Gd^Edb, Gd^Edb, Wog, Gd^Edt, Gd^Edt, Gd^Ecf, Gd^Efm, Wwf, Wog, Gd^Fdw, Rb^Efm, Gll, Wwg
Wwf, Wwf, Gll^Fdw, Wog, Wwf^Wkf, Gll^Fdw, Wwf, Aa^Fma, Aa, Aa^Fma, Gs, Aa^Fma, Gs^Efm, Ms, Gll^Efm, Ms, Md, Ms, Hhd, Gll, Gd, Gll, Wwg, Aa^Fma, Hhd^Emf, Wwf, Aa^Esa, Gll^Es, Gll, Gd^Vo, Gd, Gd^Esa, Gd^Edt, Gd^Efm, Wwf, Gd^Edt, Wog, Wog, Wog, Rb, Rb, Gll^Fdw
Wwg, Wwg, Gll, Gll^Fdw, Wog, Gll, Gll, Gll^Es, Gd, Gd^Fdw, Gd, Gs, Gd, Gd^Efm, Aa^Voa, Aa^Fma, Md, Md, Md, Gll^Esa, Gll^Esa, Gd^Esa, Wwg, Wog, Aa^Fma, Aa^Fma, Wog, Wwg, Rb^Efm, Gll^Fdw, Rb^Edb, Rb, Rb, Wwrg, Wog, Wog, Gd, Gll, Gd, Gd^Fdf, Gd^Fdf, Rb
Gll, Gll^Fdw, Wwf, Wwf^Wkf, Wog, Wog, Wwg, Gd^Fdw, Wog, Wog, Wwf^Wkf, Aa, Aa, Gd^Fdw, Aa^Fma, Aa, Md, Md, Md, Ha, Gll^Em, Gd^Em, Gd^Esa, Wog, Wog, Wog, Gd^Efm, Gll^Efm, Gll, Rb, Wog, Md, Md, Wwf^Wkf, Chw, Wwf, Gll^Fdw, Gll, Gll, Ms, Gd^Fdf, Gd
Wwf, Wwg, Gll^Vhhr, Rb, Chw, Chw, Khw, Wwrg, Gs, Hhd, Gll^Fdw, Wwf^Wkf, Aa^Esa, Gd^Esa, Aa^Esa, Md, Md, Md, Ha^Esa, Ha, Md, Gll^Em, Gll, Wwg, Gd^Fdw, Gs^Efm, Gs^Efm, Gll, Gs, Md, Gd, Wog, Wwf^Wkf, Wwf^Wkf, Khw, Chw, Gll^Fdw, Gd, Wog, Gll, Gd, Gd
Gll, Gll, Md, Rb, Gs, Chw, Wwg, Wog, Hhd^Fdw, Hhd, Gll, Aa, Gd, Gs, Gs^Edb, Aa^Fma, Aa^Fma, Ha, Aa^Fma, Aa^Fma, Md, Hhd, Hhd, Gll, Gll^Fdw, Gd^Efm, Gd^Fdw, Wog, Gd^Vc, Gd, Gll^Efm, Wog, Wwrg, Chw, Gd^Fmw, Gd, Rb, Gll, Gd, Gd, Wwg^Wkf, Wwg
Gll, Md, Md, Gll, Gs, Gll^Fdw, Gs, Gs, Gd^Fdw, Ms, Gd^Edb, Gd, Gd, Gll^Efm, Gll, Gs^Edb, Gll^Edb, Aa^Feta, Gd, Gd^Es, Gll^Es, Md, Hhd^Fdw, Hhd^Fmw, Md, Gd, Gll, Gd, Gd, Gd^Fdw, Gd^Fdw, Wog, Hhd, Hhd, Gd^Fdw, Gd^Fdw, Rb, Wwg, Wwg, Wwg^Wkf, Rb, Rb
Gll^Fdw, Gd, Md, Gll^Fdw, Gd, Ms, Gd^Fdw, Gd^Fmw, Gd^Edb, Gd^Edb, Gd, Gd^Vo, Gd^Es, Gd, Wwf, Gll, Wwf^Ewl, Gll, Gd, Gd^Es, Gd^Fdw, Hhd^Emf, Gd^Fdw, Gll^Fdw, Gd, Gd, Wog, Wwg, Wog, Gd^Esa, Gd^Esa, Gll, Hhd^Fdw, Gd^Fdw, Gd, Gd, Rb, Wog, Rb, Rb, Wog, Gll
Md, Gll^Fdw, Wwf, Gll, Gll^Esa, Gll, Gd, Gd, Gd, Gd^Fdw, Gll, Gd, Gd^Edt, Md, Md, Wog, Hhd, Wog, Gd^Fdw, Gd^Esa, Gll, Hhd, Gll^Fdw, Gd^Fetd, Gd, Wog, Wwg, Wwrg, Wog, Wwf^Wkf, Wog, Wwf, Gd^Fdw, Gd^Fdw, Hhd^Fdw, Gd, Gll^Wm, Rb, Gd^Fdw, Gs, Gd, Gll
Md, Wwf, Hhd, Wwf, Gll, Gd^Fdw, Gd, Wog, Gd^Efm, Gll^Edt, Ha, Gll^Edt, Aa, Hhd, Ms, Hhd^Dr, Hhd^Emf, Gd^Fdw, Gs^Edb, Gd, Gd^Es, Gll, Gd^Vhr, Gd, Gll, Gll, Wog, Wog, Wwf, Wwf, Gd, Gd^Esa, Gs^Vl, Gd, Gd^Efm, Gd, Gll, Gll, Gd, Gd, Gd^Es, Gll
Md, Hhd^Fdw, Md, Md, Md, Gll, Gll^Efm, Gd^Efm, Gll^Fdw, Gll^Fdw, Ha, Wwf, Ms, Ha, Ms, Ms^Xm, Ms, Hhd^Fdw, Gll, Gs^Edb, Gs, Gd^Esa, Gll^Esa, Gd, Wog, Gd^Fdw, Wwrg, Wwf, Hhd^Fdw, Wog, Ai, Gd^Em, Gd^Esa, Gd^Fdw, Gd, Gd^Efm, Md, Gll^Edt, Hhd^Esa, Gll^Fdw, Gd, Gd^Fdw
Md, Hhd, Md, Md, Md, Md, Gll^Fdw, Gd^Efm, Gll^Efm, Hhd^Fdw, Ms, Wwf, Ms, Ms, Ha^Vhha, Ms, Wwf, Wwg, Gs^Vl, Gs^Edb, Gd^Edb, Gd^Esa, Gd, Gll, Wog, Gd^Fdw, Gll, Wwf, Md, Gd, Ai, Gd^Em, Gd, Gll, Gd^Efm, Md, Gll^Esa, Gll^Esa, Hhd, Gd^Esa, Gd^Esa, Gd^Fdw
Aa^Fma, Md, Md, Ha^Vhha, Md, Md, Gd, Gd^Esa, Aa^Fma, Hhd^Fdw, Aa^Fma, Wwf, Wog, Ha, Wwg, Hhd, Wog, Gll, Rb, Gs^Edb, Gd^Efm, Gd, Wwf, Wog, Rb^Es, Gd^Fmw, Gll, Md, Gll, Gd, Ai, Hhd^Fdw, Hhd, Gll, Md, Md, Hhd, Hhd^Fdw, Gd^Fdw, Gd^Edb, Gll, Gd
Aa^Fma, Gll^Fdw, Gd^Efm, Md, Gll, Gd^Edt, Gd^Fdw, Gd^Esa, Aa^Esa, Aa^Fma, Re, Re, Ms, Wog, Wog, Wog, Wwrg, Gll^Edb, Rb^Edb, Gd^Edb, Wwf^Wkf, Wwf, Rra, Hhd^Emf, Hhd^Em, Rb, Gll, Md, Ms, Hhd, Md, Hhd^Em, Hhd^Emf, Gll^Edb, Gll^Edb, Md, Gll, Gd^Fdw, Gll, Gd^Edb, Hhd, Gll
Hhd, Aa^Fma, Aa, Aa^Fma, Aa^Fma, Gll^Es, Gll, Gd^Esa, Re, Re^Esa, Aa, Aa^Fma, Aa^Esa, Aa, Wog, Wwf^Wkf, Gll^Fdw, Gll^Wm, Rb, Wwf, Khw, Chw, Rra, Rra, Rra, Rb, Md, Md, Aa^Fma, Hhd^Fdw, Hhd^Fpa, Hhd^Em, Hhd, Hhd, Gll^Edb, Md, Md, Gll, Gll^Edb, Gd^Edb, Hhd^Fdf, Gll
Hhd, Hhd, Ha, Ha^Fdw, Ha^Fdw, Hhd^Fdw, Hhd^Fdw, Gll, Rb, Gd^Fdw, Gd^Fdw, Wwf, Gd, Re^Fdw, Re^Fdw, Re, Rb^Edb, Rb^Edb, Gll^Es, Wog, Chw, Rra, Wwf, Wog, Rb, Rb, Rb, Md, Rb, Aa^Fpa, Aa^Fma, Wwrg, Hhd^Dr, Ms, Ms, Gll, Gll, Md, Gll, Hhd^Fdw, Hhd, Gll
Md, Md, Ms, Ms, Ms, Ai, Md, Gll, Rb, Hhd^Fdw, Hhd^Fdw, Gd, Gll, Gll, Gll, Rb, Wwf, Wwf^Es, Wwf^Ewl, Gd^Es, Wog, Rra, Wog, Md, Gll, Gll^Wm, Gd, Rb^Efm, Gd^Efm, Gs^Vc, Aa, Wog, Wwg^Wkf, Hhd^Fdw, Hhd^Fdw, Hhd^Fdw, Gll, Md, Gll^Fdw, Hhd, Gll, Gd
Hh, Hh, Hh^Esa, Hh, Ai^Esa, Ai, Md, Md, Rb^Efm, Gs^Efm, Hhd^Vhhr, Wwf, Wog, Wwrg, Wwf, Hhd, Gll^Efm, Aa^Fma, Wwf, Wwf, Wwf^Wkf, Gd^Edt, Gll, Wwf, Wwf, Gll^Edb, Ai, Gd^Efm, Aa, Gs^Efm, Gd^Efm, Aa^Fma, Aa^Fma, Hhd, Hhd, Md, Md, Md, Aa, Aa, Gd^Esa, Gd^Fdw
Ha, Ha, Ha^Esa, Ha^Esa, Ai, Md, Gll, Rb^Efm, Gd, Gs^Efm, Gs^Efm, Hhd, Ai, Wwf^Wkf, Gd, Gd^Efm, Rp^Vhcr, Aa^Fma, Chr, Chr, Wwf, Wwf^Wkf, Wwf^Ewl, Gll^Edb, Wog, Gll^Edb, Wog, Aa, Aa, Rra, Rra, Gll, Gll^Esa, Gll, Aa^Fma, Aa, Md, Md, Hhd^Fdw, Aa, Gd^Fdw, Gd^Fdw
Ms, Ms, Ms, Ms, Ms, Ai, Hh, Gll^Fdw, Gd^Fdw, Gd, Gll^Esa, Gd^Fdw, Gd, Gd^Fdw, Hhd, Gll^Efm, Rra, Aa, Chr^Edt, 1 Khr, Chr^Edt, Wog, Wog, Wog, Wwf^Es, Wog, Wog, Ai, Aa, Aa^Feta, Rra, Gd^Fdw, Gd^Es, Gd, Aa^Fma, Aa, Hhd, Hhd^Fmf, Hhd^Fdw, Aa, Aa, Gd
Ms, Ms, Ms, Ms, Ms, Ms, Hh, Hh, Hhd^Fdw, Hhd, Hh, Gll^Esa, Ai, Ai, Rra, Rra, Ha, Rra^Edt, Chr, Chr^Edt, Hhd^Ecf, Rra^Edt, Rra, Wwf, Aa, Wwf, Wwf^Ewl, Ai, Wwg, Aa, Wwrg, Gd^Fdw, Gd^Fdw, Gg^Edb, Ai^Esa, Aa, Hhd^Esa, Hhd^Fdw, Hhd^Fdw, Hhd^Dr, Hhd, Gll
Ms, Ms, Ms^Xm, Ms, Ms, Ms, Ms, Ms^Xm, Ms, Hh, Ai, Ai, Ha, Rra, Ha, Ha, Ms, Ha, Chr, Chr, Chr^Edt, Hhd^Fdw, Ms, Ms, Ms, Aa, Ms, Ai, Ai, Wwf, Ai, Wwrg, Ai, Ai, Aa^Esa, Aa^Esa, Md, Hhd^Esa, Hhd, Hhd, Hhd^Fdf, Hhd
Ms, Ms, Ms, Ms, Ms, Ms, Ms, Ms, Ms, Ms, Ms, Ha, Ms, Ms, Ms, Ms^Xm, Ms, Ha, Chr, 2 Khr, Chr^Edt, Hhd^Vhhr, Ms, Ms, Ms^Xm, Aa, Ms, Ms, Ms, Ai, Ms, Wwrg, Aa, Aa, Ms^Xm, Md, Md, Md, Md, Md, Md, Md
Ms, Ms, Ms, Ms, Ms, Ms, Ms, Ms, Ms, Ms, Ms, Ms, Ms, Ms, Ms, Ms, Ms, Ms, Ms, Chr^Edt, Md, Hhd^Fdw, Ms, Ms, Ms, Ms, Ms, Ms, Ms, Ms, Ms, Ms, Ms, Ms, Ms, Ms, Ms, Md, Md, Md, Md, Md
