Xos, Xos, Xos, Xos, Xos, Xos, Xos, Xos, Xos, Xos, Xos, Xos, Xos, Xos, Xos, Xos, Xos, Xos, Xos, Xos, Xos, Xos, Xos, Xos, Xos, Xos, Xos, Xos, Xos, Xos, Xos, Xos, Xos, Xos, Xos, Xos, Xos, Xos
Xos, Xos, Xos, Xos, Xos, Xos, Xos, Xos, Xos, Xos, Xos, Xos, Xos, Xos, Xos, Xos, Xos, Xos, Xos, Xos, Xos, Xos, Xos^Efs, Xos, Xos, Xos, Xos, Xos, Xos, Xos, Xos, Xos, Xos, Xos, Xos, Xos, Xos, Xos
Xos, Xos, Xos, Xos, Xos, Xos, Xos, Xos, Xos, Xos, Xos, Xos, Xos, Xos, Xos, Xos, Xos^Efs, Xos, Xos, Xos, Xos, Xos, Isr, Xos^Efs, Xos, Xos, Xos, Xos, Xos, Xos, Xos, Xos, Xos, Xos, Xos, Xos, Xos, Xos
Xos, Xos, Xos, Xos, Xos^Efs, Xos^Efs, Isr, Xos^Efs, Xos, Xos, Xos, Xos, Xos, Xos, Xos, Xos^Efs, Iwo, Iwo^Ii, Iwo, Xos^Efs, Xos, Isr^Ii, Isr^Ii, Isr, Isr, Xos, Xos^Efs, Xos, Xos, Xos, Xos, Xos, Xos, Xos, Xos, Xos, Xos, Xos
Xos, Xos, Xos, Xos, Isr, Isr, Isr, Isr, Xos, Xos, Xos, Xos, Xos, Xos, Iwo, Iwo, Iwc^Ii, Iwc, Iwo, Iwo, Xos, Isr^Ii, Isr, Isr, Isr, Isr, Isr, Xos^Efs, Xos, Xos, Xos, Xos, Xos, Xos, Xos, Xos, Xos, Xos
Xos, Xos, Xos, Isr, Isr^Ii, Isr, Isr, Isr, Xos, Xos, Xos, Xos, Xos, Xos, Xos, Iwo, Iwo, Iwo, Xos, Xos, Isr^Ii, Isr^Ii, Isr, Isr, Isr, Isr, Isr^Ii, Isr, Isr, Xos, Xos, Xos, Xos, Xos, Xos, Xos, Xos, Xos
Xos, Xos, Xos, Isr, Isr, Isr, Xos, Xos, Xos, Xos, Xos, Xos, Xos, Xos, Xos, Xos, Xos, Xos, Isr^Ii, Isr^Ii, Isr, Isr, Isr, Isr, Isr, Isr, Isr, Isr^Vhcr, Isr, Xos, Xos, Xos, Xos, Xos, Xos, Xos, Xos, Xos
Xos, Xos, Xos, Xos, Xos^Efs, Xos^Efs, Isr, Xos^Efs, Xos^Efs, Xos, Xos, Xos, Xos, Xos, Xos, Xos, Xos, Xos, Xos, Isr, Isr, Isr^Ii, Isr, Isr, Xos^Efs, Xos, Xos, Isr, Isr, Xos, Xos, Xos, Xos, Xos, Xos, Xos, Xos, Xos
Xos, Xos, Xos, Xos, Isr, Isr, Isc, Isr, Isr, Xos, Xos, Xos, Xos, Xos, Xos, Xos, Xos, Xos, Xos, Xos, Xos, Isr, Xos, Xos^Efs, Isr^Ii, Isr^Ii, Isr^Ii, Xos, Xos, Xos, Xos, Xos, Xos, Xos, Xos, Xos, Xos, Xos
Xos, Xos, Xos, Isr^Ii, Isc, Isc, Isc, Isc, Isc, Isr, Xos, Xos, Xos, Xos, Xos, Xos, Xos, Xos, Xos^Efs, Xos, Xos, Xos, Isr^Ii, Isr^Ii, Isc, Isc, Isc, Isr^Ii, Isr^Ii, Xos, Xos, Xos, Xos, Xos, Xos, Xos, Xos, Xos
Xos, Xos, Xos, Isr^Ii, Isc, Isc, Isr^Ii, Isc, Isc, Isr, Xos, Xos, Xos, Xos, Xos^Efs, Xos^Efs, Cud, Cud, Cud, Xos, Xos^Efs, Xos, Isr, Isc, Isc, Isc, Isc, Isc, Isr, Xos, Xos, Xos, Xos, Xos, Xos, Xos, Xos, Xos
Xos, Xos, Xos, Isr^Ii, Isc, Isc, Isc, Isc, Isc, Isr, Isr, Xos^Efs, Xos, Xos, Isr, Isr, Cud, Isa^Ii, Cud, Isr, Isr, Xos^Efs, Isr, Isc, Isc, Isr^Ii, Isc, Isc, Isr, Xos, Xos, Xos, Xos, Xos, Xos, Xos, Xos, Xos
Xos, Xos, Xos, Isr^Ii, Isr^Ii, Isc, Isc, Isc, Isr, Isr, Isr, Isr, Isr, Isr, Isr, Isr, Xos, Xos, Xos, Isr, Isr, Isr, Isr, Isc, Isc, Isc, Isc, Isc, Isr, Xos, Xos, Xos, Xos, Xos, Xos, Xos, Xos, Xos
Xos, Xos, Xos, Xos, Xos, Isr^Ii, Isr^Ii, Isr, Xos, Xos, Xos, Isr, Isr, Isr^Vhcr, Isr, Xos, Cud, Isa^Ii, Cud, Xos, Xos, Isr, Xos, Isr, Isr, Isc, Isr, Isr, Xos, Xos, Xos, Xos, Xos, Xos, Xos, Xos, Xos, Xos
Xos, Xos, Xos, Xos, Xos, Xos, Xos, Xos, Xos, Xos, Xos, Xos, Xos, Isr, Xos, Xos, Isa^Em, Cud, Isa^Em, Xos, Xos, Xos, Xos, Xos, Xos, Isr, Xos, Xos, Xos, Xos, Xos, Xos, Xos, Xos, Xos, Xos, Xos, Xos
Xos, Xos, Xos, Xos, Xos, Xos, Xos, Xos, Xos, Xos, Xos, Xos, Xos, Xos, Xos, Xos, Isa, Isa^Em, Isa, Xos, Xos, Xos, Xos, Xos, Xos, Xos, Xos, Xos, Xos, Xos, Xos, Xos, Xos, Xos, Xos, Xos, Xos, Xos
Xos, Xos, Xos, Xos, Xos, Xos, Xos, Xos, Xos, Xos, Xos, Xos, Xos, Xos, Xos, Xos, Isa, Isa^Vhcr, Isa^Em, Xos, Xos, Xos, Xos, Xos, Xos, Xos, Xos, Xos, Xos, Xos, Xos, Xos, Xos, Xos, Xos, Xos, Xos, Xos
Xos, Xos, Xos, Xos, Xos, Xos, Xos, Xos, Xos, Xos, Xos, Xos, Xos, Xos, Xos^Efs, Xos, Isa, Isa, Isa^Em, Xos, Xos^Efs, Xos, Xos, Xos, Xos, Xos, Xos, Xos, Xos, Xos, Xos, Xos, Xos, Xos, Xos, Xos, Xos, Xos
Xos, Xos, Xos, Xos, Xos, Xos, Xos, Xos, Xos, Xos, Xos, Xos, Xos, Xos^Efs, Isa, Isa, Isa^Ii, Isa^Ii, Isa^Ii, Isa^Em, Isa, Xos, Xos^Efs, Xos, Xos, Xos, Xos, Xos, Xos, Xos, Xos, Xos, Xos, Xos, Xos, Xos, Xos, Xos
Xos, Xos, Xos, Xos, Xos, Xos, Xos, Xos, Xos, Xos, Xos, Xos, Isa^Em, Isa, Isa^Edt, Isa^Ii, Wwf^Ewl, Wwf, Isa^Ii, Isa, Isa, Isa, Isa, Xos^Efs, Xos^Efs, Xos, Xos, Xos, Xos, Xos, Xos, Xos, Xos, Xos, Xos, Xos, Xos, Xos
Xos, Xos, Xos, Xos, Xos, Xos, Xos, Xos, Xos^Efs, Xos^Efs, Isa^Em, Isa^Em, Isa^Edt, Isa^Edt, Wwrg, Wwf, Isa^Ii, Isa^Ii, Isa, Isa, Xos, Isa, Isa, Isa, Isa, Xos, Xos, Xos, Xos, Xos, Xos, Xos, Xos, Xos, Xos, Xos, Xos, Xos
Xos, Xos, Xos, Xos, Xos, Xos, Xos^Efs, Xos, Isa, Isa, Isa^Em, Isa^Edt, Xos, Xos, Isa, Isa^Es, Isa^Es, Isa^Es, Xos, Xos, Isa, Isa, Isa^Edt, Isa^Edt, Isa^Edt, Isa, Isa, Xos^Efs, Xos, Xos, Xos, Xos, Xos, Xos, Xos, Xos, Xos, Xos
Xos, Xos, Xos, Xos, Xos^Efs, Xos^Efs, Isa, Isa, Isa, Isa, Xos, Xos, Isa^Edt, Isa, Isa, Isa, Xos, Xos, Isa, Isa, Isa, Isa, Wwf, Wwf, Ur^Edt, Ur^Edt, Ur^Edt, Isa^Em, Xos, Xos, Xos, Xos, Xos, Xos, Xos, Xos, Xos, Xos
Xos, Xos, Xos, Xos, Isa, Isa, Isa, Isa, Xos, Xos, Isa^Edt, Isa^Edt, Isa, Isa, Xos, Xos, Isa^Edt, Isa^Edt, Isa, Isa, Wwrg, Wwf^Ewl, Isa^Edt, Ur^Edt, Chr, 3 Khr, Chr, Ur^Em, Xos, Xos, Xos, Xos, Xos, Xos, Xos, Xos, Xos, Xos
Xos, Xos, Xos, Ur, Ur^Edt, Isa, Xos, Xos, Isa^Vhcr, Isa^Edt, Isa, Isa, Xos, Xos, Isa^Edt, Isa^Edt, Isa, Isa, Xos, Xos, Isa^Edt, Isa, Isa^Vhcr, Ur^Edt, Xos, Xos, Ur^Edt, Ur^Edt, Xos, Xos, Xos, Xos, Xos, Xos, Xos, Xos, Xos, Xos
Xos, Xos, Xos, Ur^Edt, Chr, Xos, Chr, Ur^Edt, Isa, Isa, Xos, Xos, Isa^Em, Isa^Edt, Isa^Em, Isa, Xos, Xos, Isa^Edt, Isa^Edt, Isa, Isa, Xos, Xos, Isa, Isa, Isa, Isa, Xos, Xos, Xos, Xos, Xos, Xos, Xos, Xos, Xos, Xos
Xos, Xos, Xos, Ur^Edt, Ur^Em, 2 Khr, Ur^Edt, Ur^Edt, Wwrg, Xos, Isa, Isa, Isa, Isa^Em, Xos, Xos, Isa, Isa^Edt, Isa, Isa, Xos, Xos, Isa^Es, Isa^Es, Isa^Ii, Isa^Ii, Isa^Ii, Isa, Xos, Xos, Xos, Xos, Xos, Xos, Xos, Xos, Xos, Xos
Xos, Xos, Xos, Ur, Isa, Ur^Em, Wwf, Wwf, Isa^Edt, Isa^Edt, Isa^Em, Isa^Em, Xos, Xos, Isa, Isa, Isa, Isa, Xos, Xos, Isa, Isa, Isa^Es, Isa^Ii, Wwf^Ewl, Wwf, Isa^Ii, Isa, Xos, Xos, Xos, Xos, Xos, Xos, Xos, Xos, Xos, Xos
Xos, Xos, Xos, Ur, Isa, Wwf^Ewl, Isa, Isa, Isa, Isa, Xos, Xos, Isa, Isa, Isa, Isa, Xos, Xos, Isa^Edt, Isa^Edt, Isa, Isa, Wwrg, Wwf, Isa^Ii, Isa^Ii, Ur, Ur, Xos, Xos, Xos, Xos, Xos, Xos, Xos, Xos, Xos, Xos
Xos, Xos, Xos, Ur, Isa, Isa, Isa, Isa, Xos, Xos, Isa^Es, Isa^Es, Isa^Es, Isa, Xos, Xos, Isa^Edt, Isa^Em, Isa, Isa, Xos, Xos, Isa, Isa^Em, Ur, Ur, Xos, Xos, Xos, Xos, Xos, Xos, Xos, Xos, Xos, Xos, Xos, Xos
Xos, Xos, Xos, Ur, Isa, Isa, Isa, Xos, Isa, Isa, Isa^Ii, Isa^Ii, Wwf, Wwrg, Isa, Isa^Edt, Isa, Isa^Em, Xos, Xos, Isa, Isa, Ur^Em, Ur^Em, Xos, Xos, Xos, Xos, Xos, Xos, Xos, Xos, Xos, Xos, Xos, Xos, Xos, Xos
Xos, Xos, Xos, Xos, Xos, Isa, Isa, Isa, Isa, Isa^Ii, Wwf^Ewl, Wwf, Isa^Ii, Isa, Isa, Isa, Xos, Xos, Isa, Isa, Ur^Em, Ur^Em, Xos, Xos, Xos, Xos, Xos, Xos, Xos, Xos, Xos, Xos, Xos, Xos, Xos, Xos, Xos, Xos
Xos, Xos, Xos, Xos, Xos, Xos, Xos, Isa, Isa, Isa^Ii, Isa^Ii, Isa^Ii, Isa^Edt, Isa, Xos, Xos, Isa, Isa, Ur^Em, Ur^Em, Xos, Xos, Xos, Xos, Xos, Xos, Xos, Xos, Xos, Xos, Xos, Xos, Xos, Xos, Xos, Xos, Xos, Xos
Xos, Xos, Xos, Xos, Xos, Xos, Xos, Xos, Xos, Isa, Isa, Isa, Isa^Edt, Xos, Isa^Edt, Isa^Edt, Ur, Ur, Xos, Xos, Xos, Xos, Xos, Xos, Xos, Xos, Xos, Xos, Xos, Xos, Xos, Xos, Xos, Xos, Xos, Xos, Xos, Xos
Xos, Xos, Xos, Xos, Xos, Xos, Xos, Xos, Xos, Xos, Xos, Isa, Isa, Isa^Edt, Isa, Ur, Xos, Xos, Xos, Xos, Xos, Xos^Efs, Iwo^Ii, Iwo^Ii, Iwo, Xos^Efs, Xos^Efs, Xos, Xos, Xos, Xos, Xos, Xos, Xos, Xos, Xos, Xos, Xos
Xos, Xos, Xos, Xos, Xos, Xos, Xos, Xos, Xos, Xos, Xos, Xos, Xos, Isa, Isa, Ur, Urb, Xos^Efs, Xos^Efs, Xos, Iwo^Ii, Iwo^Ii, Iwc, Iwc, Iwc, Iwo, Iwo, Xos^Efs, Xos, Xos, Xos, Xos, Xos, Xos, Xos, Xos, Xos, Xos
Xos, Xos, Xos, Xos, Xos, Xos, Xos, Xos, Xos, Xos, Xos, Xos, Xos, Xos, Xos, Uu, Wwf, Urb, Urb, Xos^Efs, Xos, Iwo, Iwo, Iwc, Iwc, Iwc, Iwc, Iwo, Iwo, Xos^Efs, Xos, Xos, Xos, Xos^Efs, Iwo^Ii, Xos, Xos, Xos
Xos, Xos, Xos, Xos, Xos, Xos, Xos, Xos, Xos, Xos, Xos, Xos, Xos, Xos, Xos, Xos^Efs, Wwf, Uu^Ii, Isa^Es, Isa, Isa, Xos, Xos^Efs, Iwo, Iwo, Iwc, Iwc^Ii, Iwc, Iwo, Iwo, Xos^Efs, Xos^Efs, Iwo, Iwo, Iwo^Ii, Xos, Xos, Xos
Xos, Xos, Xos, Xos, Xos, Xos, Xos, Xos, Xos, Xos, Xos, Xos, Xos, Xos, Xos, Wwf^Ewl, Uu^Ii, Uu^Ii, Isa^Es, Isa^Ii, Isa, Isa, Ur^Edt, Xos, Xos, Iwo, Iwo, Iwo, Xos^Efs, Xos, Iwo, Iwo, Iwc, Iwc, Iwo^Ii, Xos, Xos, Xos
Xos, Xos, Xos, Xos, Xos, Xos, Xos, Xos, Xos^Efs, Xos, Xos, Xos, Xos, Xos, Xos, Ur, Isa^Es, Isa^Ii, Isa^Es, Isa, Ur^Edt, Ur^Edt, Isa^Ii, Isa, Xos, Xos, Xos, Xos^Efs, Iwo, Iwo, Iwc, Iwc, Iwc, Iwc, Iwo^Ii, Xos, Xos, Xos
Xos, Xos, Xos, Xos, Xos, Xos, Xos, Iwo^Ii, Iwo, Xos, Xos^Efs, Xos, Xos, Xos, Xos, Ur^Edt, Isa, Isa^Es, Isa^Em, Isa, Ur^Vhcr, Isa, Urb, Urb, Xos, Xos^Efs, Xos, Xos^Efs, Iwo, Iwc^Ii, Iwc, Iwc, Iwc, Iwc, Iwo^Ii, Xos, Xos, Xos
Xos, Xos, Xos, Xos, Xos, Xos, Xos, Iwo^Ii, Iwc, Iwo, Iwo, Xos^Efs, Xos^Efs, Xos, Xos, Ur^Edt, Isa, Isa, Isa^Em, Isa, Uu^Em, Uu^Edt, Xos^Efs, Xos, Uu^Em, Uu^Em, Ur^Es, Xos^Efs, Xos^Efs, Iwo, Iwo, Iwc, Iwc, Iwc, Iwo^Ii, Xos, Xos, Xos
Xos, Xos, Xos, Xos, Xos, Xos, Xos, Iwo^Ii, Iwc, Iwc, Iwc, Iwo, Iwo, Xos, Xos, Ur^Edt, Isa, Isa, Uu, Uu^Em, Xos, Xos^Efs, Uu, Uu^Em, Ur^Em, Ur^Vhcr, Isa, Ur^Es, Ur^Es, Xos^Efs, Xos, Iwo, Iwo, Iwc, Iwo^Ii, Xos, Xos, Xos
Xos, Xos, Xos, Xos, Xos, Xos, Xos, Iwo^Ii, Iwc, Iwc, Iwc, Iwc, Iwc^Ii, Iwo, Xos, Ur^Edt, Isa, Isa, Uu, Xos, Urb, Uu, Ur, Ur^Em, Isa^Es, Isa, Isa, Isa, Urb^Ii, Wwf, Xos, Xos, Xos, Iwo, Iwo^Ii, Xos, Xos, Xos
Xos, Xos, Xos, Xos, Xos, Xos, Xos, Iwo^Ii, Iwc, Iwc, Iwc, Iwc, Iwc, Iwo, Xos, Ur^Edt, Isa, Isa, Wwf^Ewl, Xos, Urb, Ur^Ii, Isa, Isa, Isa^Es, Isa^Ii, Isa^Ii, Urb, Wwf^Ewl, Wwf, Xos, Xos, Xos, Xos, Xos, Xos, Xos, Xos
Xos, Xos, Xos, Xos, Xos, Xos, Xos, Iwo^Ii, Iwo^Ii, Iwc, Iwc, Iwc, Iwc, Iwo, Xos, Ur, Isa^Es, Isa^Es, Wwf, Xos^Efs, Xos^Efs, Urb, Urb^Edt, Isa^Edt, Isa^Edt, Isa^Es, Isa^Ii, Urb, Xos, Xos, Xos, Xos, Xos, Xos, Xos, Xos, Xos, Xos
Xos, Xos, Xos, Xos, Xos, Xos, Xos, Xos, Xos, Iwo^Ii, Iwo^Ii, Iwc, Iwc, Iwo, Xos, Ur, Isa^Es, Isa^Ii, Isa^Ii, Wwf, Ur^Edt, Xos, Xos, Cud, Cud, Isa, Isa^Em, Xos, Xos, Xos, Xos, Xos, Xos, Xos, Xos, Xos, Xos, Xos
Xos, Xos, Xos, Xos, Xos, Xos, Xos, Xos, Xos, Xos, Xos, Iwo^Ii, Iwo^Ii, Iwo, Xos, Ur^Edt, Isa, Isa^Es, Isa, Isa^Ii, Isa^Ii, Ur^Edt, Xos, Xos, Cud^Ii, Isa, Isa^Em, Xos^Efs, Xos^Efs, Xos, Xos, Xos, Xos, Xos, Xos, Xos, Xos, Xos
Xos, Xos, Xos, Xos, Xos, Xos, Xos, Xos, Xos, Xos, Xos, Xos, Xos, Iwo^Ii, Xos, Ur^Edt, Isa, Isa, Isa^Edt, Isa^Edt, Urb, Urb, Xos^Efs, Xos^Efs, Ur, Isa, Isa, Isa^Em, Urb^Em, Xos, Xos, Xos, Xos, Xos, Xos, Xos, Xos, Xos
Xos, Xos, Xos, Xos, Xos, Xos, Xos, Xos, Xos, Xos, Xos, Xos, Xos, Xos, Xos, Ur, Isa^Ii, Isa^Edt, Urb, Urb, Xos, Xos, Ur, Ur, Isa, Isa, Isa^Edt, Isa^Edt, Urb, Cud, Xos, Xos, Xos, Xos, Xos, Xos, Xos, Xos
Xos, Xos, Xos, Xos, Xos, Xos, Xos, Xos, Xos, Xos, Xos, Xos, Xos, Xos, Xos, Ur, Urb, Urb, Xos, Xos, Xos, Ur^Edt, Isa^Edt, Isa, Isa, 1 Isa^Edt, Uu, Urb, Cud, Cud, Xos, Xos, Xos, Xos, Xos, Xos, Xos, Xos
Xos, Xos, Xos, Xos, Xos, Xos, Xos, Xos, Xos, Xos, Xos, Xos, Xos, Xos, Xos, Xos, Xos, Xos, Xos, Xos, Xos, Xos, Xos, Isa^Edt, Uu^Edt, Uu, Urb, Urb, Xos, Xos, Xos, Xos, Xos, Xos, Xos, Xos, Xos, Xos
Xos, Xos, Xos, Xos, Xos, Xos, Xos, Xos, Xos, Xos, Xos, Xos, Xos, Xos, Xos, Xos, Xos, Xos, Xos, Xos, Xos, Xos, Xos, Xos, Xos, Ur^Edt, Xos, Xos, Xos, Xos, Xos, Xos, Xos, Xos, Xos, Xos, Xos, Xos
Xos, Xos, Xos, Xos, Xos, Xos, Xos, Xos, Xos, Xos, Xos, Xos, Xos, Xos, Xos, Xos, Xos, Xos, Xos, Xos, Xos, Xos, Xos, Xos, Xos, Ur^Edt, Xos, Xos, Xos, Xos, Xos, Xos, Xos, Xos, Xos, Xos, Xos, Xos
