Xos, Xos, Xos, Xos, Xos, Xos, Xos, Xos, Xos, Xos, Xos, Xos, Xos, Xos, Xos, Xos, Xos, Xos, Xos, Xos, Xos^Efs, Xos, Xos^Efs, Xos, Xos, Xos, Xos, Xos, Xos, Xos, Xos, Xos, Xos, Xos, Xos, Xos, Xos, Xos
Xos, Xos, Xos, Xos, Xos, Xos, Xos, Xos, Xos, Xos, Xos, Xos, Xos, Xos, Xos, Xos, Xos, Xos, Xos^Efs, Xos^Efs, Wwg^Qhh, Xos^Efs, Wwg^Qhh, Xos^Efs, Xos^Efs, Xos^Efs, Xos, Xos, Xos, Xos, Xos, Xos, Xos, Xos, Xos, Xos, Xos, Xos
Xos, Xos, Xos, Xos, Xos, Xos, Xos, Xos, Xos, Xos, Xos, Xos, Xos, Xos, Xos, Xos, Xos^Efs, Xos^Efs, Wwg^Qhh, Wwg^Qhh, Isa^Qhh, Wwg^Qhh, Isa^Qhh, Isa^Qhh, Isa^Qhh, Xos^Efs, Xos^Efs, Xos, Xos, Xos, Xos, Xos, Xos, Xos, Xos, Xos, Xos, Xos
Xos, Xos, Xos^Efs, Xos^Efs, Xos^Efs, Xos^Efs, Xos^Efs, Xos^Efs, Xos^Efs, Xos, Xos, Xos, Xos, Xos, Xos^Efs, Xos^Efs, Isa^Qhh, Isa^Qhh, Isa^Qhh, Isa^Qhh, Isa^_mh, Isa^Qhh, Uu^Qhh, Isa^Qhh, Isa^Qhh, Isa^Qhh, Isa^Qhh, Xos^Efs, Xos^Efs, Xos, Xos, Xos, Xos, Xos, Xos, Xos, Xos, Xos
Xos^Efs, Xos^Efs, Isa^Qhh, Ur^Qhh, Ur^Qhh, Ur^Qhh, Isa^Qhh, Isa^Qhh, Xos^Efs, Xos^Efs, Xos^Efs, Xos^Efs, Xos^Efs, Xos^Efs, Isa^Qhh, Isa^Qhh, Isa^Qhh, Isa^Qhh, Xos^Efs, Wwg^Qhh, Isa^Qhh, Uu^Qhh, Xos^Efs, Uu^Qhh, Uu^Qhh, Isa^Qhh, Isa^Qhh, Isa^Qhh, Isa^Qhh, Xos^Efs, Xos^Efs, Xos, Xos, Xos, Xos, Xos, Xos, Xos
Xos^Efs, Isa^Qhh, Isa^Qhh, Isa^Qhh, Isa^_mh, Isa^Qhh, Isa^Qhh, Isa^Qhh, Isa^Qhh, Xos^Efs, Xos^Efs, Xos^Efs, Isa^Qhh, Isa^Qhh, Isa^Qhh, Isa^Qhh, Xos^Efs, Xos^Efs, Wwg^Qhh, Wwg^Qhh, Isa^Qhh, Uu^Qhh, Uu^Qhh, Xos^Efs, Xos^Efs, Uu^Qhh, Uu^Qhh, Isa^Qhh, Isa^Qhh, Isa^Qhh, Isa^Qhh, Xos^Efs, Xos^Efs, Xos, Xos, Xos, Xos, Xos
Xos^Efs, Isa^Qhh, Xos^Efs, Xos^Efs, Xos^Efs, Xos^Efs, Xos^Efs, Isa^Qhh, Ur^Qhh, Urc^Qhh, Xos^Efs, Urc^Qhh, Isa^Qhh, Isa^Qhh, Xos^Efs, Xos^Efs, Wwg^Qhh, Wwg^Qhh, Isa^Qhh, Isa^Qhh, Xos^Efs, Isa^Qhh, Isa^Qhh, Uu^Qhh, Ur^Qhh, Xos^Efs, Xos^Efs, Uu^Qhh, Uu^Qhh, Isa^Qhh, Isa^Qhh, Isa^Qhh, Xos^Efs, Xos, Xos, Xos, Xos, Xos
Xos^Efs, Isa^Qhh, Ur^Qhh, Isa^Qhh, Isa^Qhh, Isa^Qhh, Ur^Qhh, Ur^Qhh, Xos^Efs, Xos^Efs, Xos^Efs, Xos^Efs, Xos^Efs, Xos^Efs, Isa^Qhh, Isa^Qhh, Isa^Qhh, Isa^Qhh, Xos^Efs, Xos^Efs, Ur^Qhh, Isa^Qhh, Isa^Qhh, Isa^Qhh, Isa^Qhh, Ur^Qhh, Ur^Qhh, Xos^Efs, Xos^Efs, Uu^Qhh, Uu^Qhh, Isa^Qhh, Xos^Efs, Xos, Xos, Xos, Xos, Xos
Xos^Efs, Isa^Qhh, Xos^Efs, Ur^Qhh, Ur^Qhh, Ur^Qhh, Xos^Efs, Ur^Qhh, Xos^Efs, Xos, Xos, Xos^Efs, Isa^Qhh, Isa^Qhh, Isa^Qhh, Isa^Qhh, Xos^Efs, Xos^Efs, Uu^Qhh, Ur^Qhh, Isa^Qhh, Isa^Qhh, Xos^Efs, Isa^Qhh, Isa^Qhh, Isa^Qhh, Isa^Qhh, Ur^Qhh, Ur^Qhh, Xos^Efs, Xos^Efs, Uu^Qhh, Xos^Efs, Xos, Xos, Xos, Xos, Xos
Xos^Efs, Isa^Qhh, Isa^Qhh, Xos^Efs, Xos^Efs, Xos^Efs, Isa^Qhh, Ur^Qhh, Xos^Efs, Xos, Xos, Xos^Efs, Isa^Qhh, Isa^Qhh, Xos^Efs, Xos^Efs, Uu^Qhh, Uu^Qhh, Isa^Qhh, Isa^Qhh, Isa^Qhh, Isa^Qhh, Isa^Qhh, Xos^Efs, Xos^Efs, Isa^Qhh, Isa^Qhh, Isa^Qhh, Isa^Qhh, Ur^Qhh, Ur^Qhh, Xos^Efs, Xos^Efs, Xos, Xos, Xos, Xos, Xos
Xos^Efs, Isa^Qhh, Isa^Qhh, Isa^Qhh, Isa^Qhh, Isa^Qhh, Isa^Qhh, Ur^Qhh, Xos^Efs, Xos, Xos, Xos^Efs, Xos^Efs, Xos^Efs, Uh^Qhh, Uu^Qhh, Isa^Qhh, Isa^Qhh, Xos^Efs, Xos^Efs, Isa^Qhh, Isa^Qhh, Isa^Qhh, Isa^Qhh, Isa^Qhh, Xos^Efs, Xos^Efs, Isa^Qhh, Isa^Qhh, Isa^Qhh, Isa^Qhh, Ur^Qhh, Xos^Efs, Xos, Xos, Xos, Xos, Xos
Xos^Efs, Isa^Qhh, Xos^Efs, Isa^Qhh, Isa^Qhh, Isa^Qhh, Xos^Efs, Xos^Efs, Xos^Efs, Xos, Xos, Xos^Efs, Uh^Qhh, Uh^Qhh, Isa^Qhh, Isa^Qhh, Xos^Efs, Xos^Efs, Ur^Qhh, Ur^Qhh, Isa^Qhh, Isa^Qhh, Xos^Efs, Isa^Qhh, Isa^Qhh, Isa^Qhh, Isa^Qhh, Xos^Efs, Xos^Efs, Isa^Qhh, Isa^Qhh, Ur^Qhh, Xos^Efs, Xos, Xos, Xos, Xos, Xos
Xos, Xos^Efs, Xos, Xos^Efs, Xos^Efs, Xos^Efs, Xos, Xos, Xos, Xos, Xos, Xos^Efs, Isa^Qhh, Isa^Qhh, Xos^Efs, Xos^Efs, Uu^Qhh, Uu^Qhh, Isa^Qhh, Isa^Qhh, Xos^Efs, Xos^Efs, Ur^Qhh, Isa^Qhh, Isa^Qhh, Isa^Qhh, Isa^Qhh, Isa^Qhh, Isa^Qhh, Xos^Efs, Xos^Efs, Ur^Qhh, Xos^Efs, Xos, Xos, Xos, Xos, Xos
Xos, Xos, Xos, Xos, Xos, Xos, Xos, Xos, Xos, Xos, Xos, Xos^Efs, Xos^Efs, Xos^Efs, Uh^Qhh, Uu^Qhh, Isa^Qhh, Isa^Qhh, Xos^Efs, Xos^Efs, Uu^Qhh, Ur^Qhh, Isa^Qhh, Isa^Qhh, Xos^Efs, Xos^Efs, Isa^Qhh, Isa^Qhh, Wwg^Qhh, Isa^Qhh, Isa^Qhh, Xos^Efs, Xos^Efs, Xos, Xos, Xos, Xos, Xos
Xos, Xos, Xos, Xos, Xos, Xos, Xos, Xos, Xos, Xos, Xos, Xos^Efs, Uh^Qhh, Uh^Qhh, Isa^Qhh, Isa^Qhh, Xos^Efs, Xos^Efs, Uu^Qhh, Uu^Qhh, Isa^Qhh, Isa^Qhh, Xos^Efs, Xos^Efs, Isa^Qhh, Isa^Qhh, Wwg^Qhh, Wwg^Qhh, Xos^Efs, Wwg^Qhh, Isa^Qhh, Isa^Qhh, Xos^Efs, Xos, Xos, Xos, Xos, Xos
Xos, Xos, Xos, Xos, Xos, Xos, Xos, Xos, Xos, Xos, Xos, Xos^Efs, Xos^Efs, Isa^Qhh, Xos^Efs, Xos^Efs, Uh^Qhh, Uh^Qhh, Isa^Qhh, Isa^Qhh, Xos^Efs, Xos^Efs, Isa^Qhh, Isa^Qhh, Isa^Qhh, Wwg^Qhh, Xos^Efs, Xos^Efs, Wwg^Qhh, Wwg^Qhh, Isa^Qhh, Isa^Qhh, Xos^Efs, Xos, Xos, Xos, Xos, Xos
Xos, Xos, Xos, Xos, Xos, Xos, Xos, Xos, Xos, Xos, Xos, Xos, Xos, Xos^Efs, Xos^Efs, Uh^Qhh, Isa^Qhh, Isa^Qhh, Xos^Efs, Xos^Efs, Isa^Qhh, Isa^Qhh, Isa^Qhh, Isa^Qhh, Xos^Efs, Xos^Efs, Wwg^Qhh, Wwg^Qhh, Isa^Qhh, Isa^Qhh, Xos^Efs, Xos^Efs, Xos, Xos, Xos, Xos, Xos, Xos
Xos, Xos, Xos, Xos, Xos, Xos, Xos, Xos, Xos, Xos, Xos, Xos, Xos, Xos, Xos, Xos^Efs, Xos^Efs, Isa^Qhh, Xos^Efs, Isa^Qhh, Xos^Efs, Isa^Qhh, Isa^Qhh, Xos^Efs, Wwg^Qhh, Wwg^Qhh, Isa^Qhh, Isa^Qhh, Xos^Efs, Xos^Efs, Xos, Xos, Xos, Xos, Xos, Xos, Xos, Xos
Xos, Xos, Xos, Xos, Xos, Xos, Xos, Xos, Xos, Xos, Xos, Xos, Xos, Xos, Xos, Xos, Xos^Efs, Xos^Efs, Uu, Xos^Efs, Uu, Xos^Efs, Isa, Xos^Efs, Xos^Efs, Xos^Efs, Xos^Efs, Xos^Efs, Xos, Xos, Xos, Xos, Xos, Xos, Xos, Xos, Xos, Xos
Xos, Xos, Xos, Xos, Xos, Xos, Xos, Xos, Xos, Xos, Xos, Xos, Xos, Xos, Xos, Xos, Xos^Efs, Uu, Ur, Uu, Wwf, Wwg, Wwg, Isa, Isa, Isa, Isa, Xos^Efs, Xos^Efs, Xos, Xos, Xos, Xos, Xos, Xos, Xos, Xos, Xos
Xos, Xos, Xos, Xos, Xos, Xos, Xos, Xos, Xos, Xos, Xos, Xos, Xos, Xos, Xos^Efs, Xos^Efs, Wwg, Xos^Efs, Xos^Efs, Ur, Ur, Wwf, Wwf, Wwg, Wwg, Isa, Uu, Ur, Ur, Xos^Efs, Xos^Efs, Xos, Xos, Xos, Xos, Xos, Xos, Xos
Xos, Xos, Xos, Xos, Xos, Xos, Xos, Xos, Xos, Xos, Xos, Xos, Xos^Efs, Xos^Efs, Isa, Xos^Efs, Isa, Wwg, Wwg, Ur, Ur, Ur, Ur, Wwf, Wwf, Wwg, Uu, Xos^Efs, Ur, Ur, Isa, Xos^Efs, Xos^Efs, Xos, Xos, Xos, Xos, Xos
Xos, Xos, Xos, Xos, Xos, Xos, Xos, Xos, Xos, Xos, Xos, Xos^Efs, Isa, Isa, Ur, Xos^Efs, Ur, Isa, Wwg, Xos^Efs, Xos^Efs, Ur, Ur, Ur, Uu, Uu, Xos^Efs, Xos^Efs, Ur, Ur, Isa, Isa, Isa, Xos^Efs, Xos^Efs, Xos, Xos, Xos
Xos, Xos, Xos, Xos, Xos, Xos, Xos, Xos, Xos, Xos, Xos, Xos^Efs, Isa, Ur^Vhcr, Ur, Xos^Efs, Ur, Isa, Isa, Wwg, Xos^Efs, Xos^Efs, Xos^Efs, Ur, Ur, Xos^Efs, Xos^Efs, Xos^Efs, Ur, Ur, Isa, Isa, Isa, Wwg, Xos^Efs, Xos, Xos, Xos
Xos, Xos, Xos, Xos, Xos, Xos, Xos, Xos, Xos, Xos, Xos, Xos^Efs, Isa, Ur, Xos^Efs, Ur, Isa, Isa, Isa, Wwg, Xos^Efs, Ql, Ql, Xos^Efs, Xos^Efs, Ur, Ur, Xos^Efs, Xos^Efs, Ur, Ur, Isa, Isa, Wwg, Xos^Efs, Xos, Xos, Xos
Xos, Xos, Xos, Xos, Xos, Xos, Xos, Xos, Xos, Xos, Xos, Xos^Efs, Xos^Efs, Xos^Efs, Isa, Isa, Ur, Ur, Isa, Wwg, Xos^Efs, Ql, Ur, Ql, Xos^Efs, Ur, Ur, Wwg, Wwg, Xos^Efs, Xos^Efs, Ur, Xos^Efs, Xos^Efs, Xos^Efs, Xos, Xos, Xos
Xos, Xos, Xos, Xos, Xos, Xos, Xos, Xos, Xos, Xos, Xos, Xos^Efs, Xos^Efs, Isa, Ur, Ur, Ur, Ur, Xos^Efs, Xos^Efs, Xos^Efs, Ql, Ur, Ql, Ur, Ur, Ur, Ur, Wwg, Wwg, Xos^Efs, Ur, Isa, Xos^Efs, Xos^Efs, Xos, Xos, Xos
Xos, Xos, Xos, Xos, Xos, Xos, Xos, Xos, Xos, Xos, Xos, Xos^Efs, Isa, Xos^Efs, Ur, Ur, Xos^Efs, Xos^Efs, Uue, Uue, Xos^Efs, Ql, Ur, Ur, Xos^Efs, Ur, Wwg, Wwg, Xos^Efs, Xos^Efs, Ur, Ur, Isa, Ql, Xos^Efs, Xos, Xos, Xos
Xos, Xos, Xos, Xos, Xos, Xos, Xos, Xos, Xos, Xos, Xos, Xos^Efs, Isa, Ur, Ur, Xos^Efs, Uue, Uue, Ur, Uu, Xos^Efs, Ql, Ur, Ql, Xos^Efs, Ur, Ur, Xos^Efs, Xos^Efs, Ur, Isa, Isa, Isa, Ql, Xos^Efs, Xos, Xos, Xos
Xos, Xos, Xos, Xos, Xos, Xos, Xos, Xos, Xos, Xos, Xos, Xos^Efs, Isa, Ur, Ur, Xos^Efs, Ur, Ur, Isa, Uu, Xos^Efs, Ql, Ur, Ql, Xos^Efs, Xos^Efs, Ur, Isa, Xos^Efs, Ur, Isa, Isa, Isa, Ql, Xos^Efs, Xos, Xos, Xos
Xos, Xos, Xos, Xos, Xos, Xos, Xos, Xos, Xos, Xos, Xos, Xos^Efs, Xos^Efs, Isa, Isa, Ur, Isa, Isa, Isa, Uu, Xos^Efs, Ql, Ql, Ql, Xos^Efs, Ur, Isa, Isa, Xos^Efs, Ur, Isa, Isa, Ql, Ql, Xos^Efs, Xos, Xos, Xos
Xos, Xos, Xos, Xos, Xos, Xos, Xos, Xos, Xos, Xos, Xos, Xos, Xos, Xos^Efs, Xos^Efs, Xos^Efs, Isa, Isa, Isa, Uu, Xos^Efs, Ql, Xos^Efs, Xos^Efs, Xos^Efs, Ur, Isa, Isa, Xos^Efs, Ur, Ql, Ql, Xos^Efs, Xos^Efs, Xos, Xos, Xos, Xos
Xos, Xos, Xos, Xos, Xos, Xos, Xos, Xos, Xos, Xos, Xos, Xos, Xos, Xos, Xos, Xos^Efs, Xos^Efs, Isa, Isa, Isa, Isa, Xos^Efs, Isa, Isa, Isa, Xos^Efs, Isa, Isa, Xos^Efs, Ql, Xos^Efs, Xos^Efs, Xos, Xos, Xos, Xos, Xos, Xos
Xos, Xos, Xos, Xos, Xos, Xos, Xos, Xos, Xos, Xos, Xos, Xos, Xos, Xos, Xos, Xos, Xos, Xos^Efs, Xos^Efs, Xos^Efs, Isa, Isa, Isa, Isa, Isa, Isa, Xos^Efs, Isa, Xos^Efs, Xos^Efs, Xos, Xos, Xos, Xos, Xos, Xos, Xos, Xos
Xos, Xos, Xos, Xos, Xos, Xos, Xos, Xos, Xos, Xos, Xos, Xos, Xos, Xos, Xos, Xos, Xos, Xos, Xos^Efs, Xos^Efs, Xos^Efs, Isa, Isa, Isa^Vhcr, Isa, Xos^Efs, Xos^Efs, Xos^Efs, Xos, Xos, Xos, Xos, Xos, Xos, Xos, Xos, Xos, Xos
Xos, Xos, Xos, Xos, Xos, Xos, Xos, Xos, Xos, Xos, Xos, Xos, Xos, Xos, Xos, Xos, Xos^Efs, Xos^Efs, Uu^Qhu, Uu^Qhu, Ur^Qhu, Isa, Xos^Efs, Isa, Xos^Efs, Xos^Efs, Xos, Xos, Xos, Xos, Xos, Xos, Xos, Xos, Xos, Xos, Xos, Xos
Xos, Xos, Xos, Xos, Xos, Xos, Xos, Xos, Xos, Xos, Xos, Xos, Xos, Xos, Xos^Efs, Xos^Efs, Uu^Qhu, Uu^Qhu, Ur^Qhu, Ur^Qhu, Isa^Qhu, Isa^Qhu, Isa^Qhu, Xos^Efs, Xos^Efs, Xos, Xos, Xos, Xos, Xos, Xos, Xos, Xos, Xos, Xos, Xos, Xos, Xos
Xos, Xos, Xos, Xos, Xos, Xos, Xos, Xos, Xos, Xos, Xos, Xos, Xos^Efs, Xos^Efs, Ur^Qhu, Uu^Qhu, Ur^Qhu, Ur^Qhu, Isa^Qhu, Isa^Qhu, Isa^Qhu, Isa^Qhu, Isa^Qhu, Isa^Qhu, Xos^Efs, Xos^Efs, Xos^Efs, Xos, Xos, Xos, Xos, Xos, Xos, Xos, Xos, Xos, Xos, Xos
Xos, Xos, Xos, Xos, Xos, Xos, Xos, Xos, Xos, Xos, Xos^Efs, Xos^Efs, Ai^Qhu, Xos^Efs, Xos^Efs, Ur^Qhu, Ur^Qhu, Isa^Qhu, Isa^Qhu, Isa^Qhu, Isa^Qhu, Isa^Qhu, Xos^Efs, Xos^Efs, Ur^Qhu, Wwg^Qhu, Wwg^Qhu, Xos^Efs, Xos^Efs, Xos, Xos, Xos, Xos, Xos, Xos, Xos, Xos, Xos
Xos, Xos, Xos, Xos, Xos, Xos, Xos, Xos, Xos^Efs, Xos^Efs, Ai^Qhu, Ai^Qhu, Ur^Qhu, Ai^Qhu, Qxua^Qhu, Xos^Efs, Xos^Efs, Ur^Qhu, Ur^Qhu, Isa^Qhu, Isa^Qhu, Xos^Efs, Ur^Qhu, Ur^Qhu, Isa^Qhu, Ur^Qhu, Ur^Qhu, Wwg^Qhu, Wwg^Qhu, Xos^Efs, Xos^Efs, Xos, Xos, Xos, Xos, Xos, Xos, Xos
Xos, Xos, Xos, Xos, Xos, Xos, Xos^Efs, Xos^Efs, Isa^Qhu, Xos^Efs, Xos^Efs, Ai^Qhu, Ai^Qhu, Ur^Qhu, Isa^Qhu, Qxua^Qhu, Qxua^Qhu, Xos^Efs, Xos^Efs, Ur^Qhu, Isa^Qhu, Isa^Qhu, Isa^Qhu, Isa^Qhu, Isa^Qhu, Isa^Qhu, Isa^Qhu, Ur^Qhu, Ss^Qhu, Wwg^Qhu, Wwg^Qhu, Xos^Efs, Xos, Xos, Xos, Xos, Xos, Xos
Xos, Xos, Xos, Xos, Xos, Xos, Xos^Efs, Wwg^Qhu, Isa^Qhu, Isa^Qhu, Isa^Qhu, Xos^Efs, Xos^Efs, Ai^Qhu, Ai^Qhu, Isa^Qhu, Isa^Qhu, Qxua^Qhu, Qxua^Qhu, Qxua^Qhu, Isa^Qhu, Isa^Qhu, Isa^Qhu, Xos^Efs, Xos^Efs, Isa^Qhu, Isa^Qhu, Isa^Qhu, Isa^Qhu, Ss^Qhu, Wwg^Qhu, Xos^Efs, Xos, Xos, Xos, Xos, Xos, Xos
Xos, Xos, Xos, Xos, Xos, Xos, Xos^Efs, Wwg^Qhu, Isa^Qhu, Isa^Qhu, Isa^Qhu, Ur^Qhu, Ur^Qhu, Xos^Efs, Xos^Efs, Ai^Qhu, Isa^Qhu, Isa^Qhu, Isa^Qhu, Isa^Qhu, Xos^Efs, Isa^Qhu, Isa^Qhu, Isa^Qhu, Isa^Qhu, Xos^Efs, Xos^Efs, Isa^Qhu, Isa^Qhu, Ss^Qhu, Wwg^Qhu, Xos^Efs, Xos, Xos, Xos, Xos, Xos, Xos
Xos, Xos, Xos, Xos, Xos, Xos, Xos^Efs, Wwg^Qhu, Wwg^Qhu, Isa^Qhu, Isa^Qhu, Isa^Qhu, Ur^Qhu, Qxua^Qhu, Qxua^Qhu, Qxua^Qhu, Isa^Qhu, Isa^Qhu, Xos^Efs, Xos^Efs, Isa^Qhu, Isa^Qhu, Isa^Qhu, Isa^Qhu, Isa^Qhu, Isa^Qhu, Isa^Qhu, Xos^Efs, Xos^Efs, Ss^Qhu, Wwg^Qhu, Xos^Efs, Xos, Xos, Xos, Xos, Xos, Xos
Xos, Xos, Xos, Xos, Xos, Xos, Xos^Efs, Xos^Efs, Xos^Efs, Wwg^Qhu, Wwg^Qhu, Isa^Qhu, Isa^Qhu, Ur^Qhu, Isa^Qhu, Isa^Qhu, Xos^Efs, Xos^Efs, Uu^Qhu, Uu^Qhu, Uu^Qhu, Isa^Qhu, Xos^Efs, Isa^Qhu, Isa^Qhu, Isa^Qhu, Isa^Qhu, Qxua^Qhu, Ql^Qhu, Xos^Efs, Xos^Efs, Xos^Efs, Xos, Xos, Xos, Xos, Xos, Xos
Xos, Xos, Xos, Xos, Xos, Xos, Xos^Efs, Wwg^Qhu, Wwg^Qhu, Xos^Efs, Xos^Efs, Wwg^Qhu, Wwg^Qhu, Isa^Qhu, Isa^Qhu, Xos^Efs, Uu^Qhu, Uu^Qhu, Isa^Qhu, Uu^Qhu, Isa^Qhu, Uu^Qhu, Uu^Qhu, Xos^Efs, Xos^Efs, Isa^Qhu, Isa^Qhu, Qxua^Qhu, Qxua^Qhu, Ql^Qhu, Ql^Qhu, Xos^Efs, Xos, Xos, Xos, Xos, Xos, Xos
Xos, Xos, Xos, Xos, Xos, Xos, Xos^Efs, Wwg^Qhu, Isa^Qhu, Wwg^Qhu, Wwg^Qhu, Xos^Efs, Wwg^Qhu, Isa^Qhu, Isa^Qhu, Isa^Qhu, Isa^Qhu, Isa^Qhu, Xos^Efs, Isa^Qhu, Isa^Qhu, Isa^Qhu, Isa^Qhu, Uu^Qhu, Uu^Qhu, Xos^Efs, Xos^Efs, Isa^Qhu, Isa^Qhu, Qxua^Qhu, Ql^Qhu, Xos^Efs, Xos, Xos, Xos, Xos, Xos, Xos
Xos, Xos, Xos, Xos, Xos, Xos, Xos^Efs, Wwg^Qhu, Isa^Qhu, Isa^Qhu, Isa^Qhu, Wwg^Qhu, Isa^Qhu, Isa^Qhu, Xos^Efs, Xos^Efs, Isa^Qhu, Isa^Qhu, Isa^Qhu, Xos^Efs, Xos^Efs, Isa^Qhu, Isa^Qhu, Isa^Qhu, Isa^Qhu, Uu^Qhu, Uu^Qhu, Xos^Efs, Xos^Efs, Qxua^Qhu, Ql^Qhu, Xos^Efs, Xos, Xos, Xos, Xos, Xos, Xos
Xos, Xos, Xos, Xos, Xos, Xos, Xos^Efs, Wwg^Qhu, Isa^Qhu, Isa^Qhu, Isa^Qhu, Isa^Qhu, Xos^Efs, Xos^Efs, Isa^Qhu, Isa^Qhu, Ur^Qhu, Isa^_ml, Isa^Qhu, Isa^Qhu, Isa^Qhu, Xos^Efs, Xos^Efs, Isa^Qhu, Isa^Qhu, Isa^Qhu, Isa^Qhu, Uu^Qhu, Uu^Qhu, Xos^Efs, Ql^Qhu, Xos^Efs, Xos, Xos, Xos, Xos, Xos, Xos
Xos, Xos, Xos, Xos, Xos, Xos, Xos, Xos^Efs, Xos^Efs, Isa^Qhu, Xos^Efs, Xos^Efs, Isa^Qhu, Isa^Qhu, Isa^Qhu, Ur^Qhu, Xos^Efs, Ur^Qhu, Ur^Qhu, Isa^Qhu, Isa^Qhu, Isa^Qhu, Isa^Qhu, Xos^Efs, Xos^Efs, Isa^Qhu, Xos^Efs, Isa^Qhu, Uu^Qhu, Xos^Efs, Xos^Efs, Xos^Efs, Xos, Xos, Xos, Xos, Xos, Xos
Xos, Xos, Xos, Xos, Xos, Xos, Xos, Xos, Xos, Xos^Efs, Xos^Efs, Ur^Qhu, Ur^Qhu, Isa^Qhu, Isa^Qhu, Ur^Qhu, Ur^Qhu, Xos^Efs, Xos^Efs, Ur^Qhu, Ur^Qhu, Isa^Qhu, Isa^Qhu, Isa^Qhu, Isa^Qhu, Xos^Efs, Ur^Qhu, Xos^Efs, Xos^Efs, Xos^Efs, Xos, Xos, Xos, Xos, Xos, Xos, Xos, Xos
Xos, Xos, Xos, Xos, Xos, Xos, Xos, Xos, Xos, Xos, Xos, Xos^Efs, Xos^Efs, Ur^Qhu, Ur^Qhu, Isa^Qhu, Isa^Qhu, Ur^Qhu, Ur^Qhu, Xos^Efs, Xos^Efs, Ur^Qhu, Ur^Qhu, Isa^Qhu, Ur^Qhu, Ur^Qhu, Xos^Efs, Xos^Efs, Xos, Xos, Xos, Xos, Xos, Xos, Xos, Xos, Xos, Xos
Xos, Xos, Xos, Xos, Xos, Xos, Xos, Xos, Xos, Xos, Xos, Xos, Xos, Xos^Efs, Xos^Efs, Ur^Qhu, Ur^Qhu, Isa^Qhu, 1 Isa^Qhu, Ur^Qhu, Ur^Qhu, Xos^Efs, Xos^Efs, Ur^Qhu, Xos^Efs, Xos^Efs, Xos, Xos, Xos, Xos, Xos, Xos, Xos, Xos, Xos, Xos, Xos, Xos
Xos, Xos, Xos, Xos, Xos, Xos, Xos, Xos, Xos, Xos, Xos, Xos, Xos, Xos, Xos, Xos^Efs, Xos^Efs, Ur^Qhu, Isa^Qhu, Isa^Qhu, Ur^Qhu, Ur^Qhu, Xos^Efs, Xos^Efs, Xos, Xos, Xos, Xos, Xos, Xos, Xos, Xos, Xos, Xos, Xos, Xos, Xos, Xos
Xos, Xos, Xos, Xos, Xos, Xos, Xos, Xos, Xos, Xos, Xos, Xos, Xos, Xos, Xos, Xos, Xos, Xos^Efs, Xos^Efs, Ur^Qhu, Xos^Efs, Xos^Efs, Xos, Xos, Xos, Xos, Xos, Xos, Xos, Xos, Xos, Xos, Xos, Xos, Xos, Xos, Xos, Xos
Xos, Xos, Xos, Xos, Xos, Xos, Xos, Xos, Xos, Xos, Xos, Xos, Xos, Xos, Xos, Xos, Xos, Xos, Xos^Efs, Ur^Qhu, Xos^Efs, Xos, Xos, Xos, Xos, Xos, Xos, Xos, Xos, Xos, Xos, Xos, Xos, Xos, Xos, Xos, Xos, Xos
