Ha, Ai, Ha^Esa, Ha, Gd, Md, Gd^Fdw, Gd^Esa, Gd^Esa, Md, Md, Md, Hhd^Fp, Hhd, Md, Md, Md^Xm, Md^Xm, Md, Aa^Esa, Aa^Esa, Gll^Esa, Md, Md, Md, Md, Md, Md, Md, Md, Md, Md^Xm, Md^Xm, Md, Md^Xm, Md^Xm, Md, Md, Md, Md, Md
Ha, Ha^Esa, Ha, Ha^Vhca, Md, Re^Efm, Gd^Fdw, Gd, Aa^Fma, Md, Md, Md, Md, Hhd^Fp, Hhd^Em, Md, Md, Md^Xm, Md, Md, Md^Xm, Md^Xm, Md^Xm, Md, Md, Md, Md, Md, Md, Md, Md, Md, Md, Md, Md, Md, Md, Md, Md^Xm, Md^Xm, Md
Ha, Ha, Aa^Es, Md, Rr, Md, Md, Aa^Fmw, Aa^Fdw, Ha, Ha^Vhca, Md^Xm, Md, Hhd^Fp, Md^Xm, Md^Xm, Md^Xm, Hhd^Emf, Md, Md, Md, Md, Md, Md, Hhd, Md, Md, Md, Md, Md, Md, Md, Md, Md, Md, Md^Xm, Md^Xm, Md^Xm, Md^Xm, Md, Md
Ha, Aa, Aa^Fma, Ch, 2 Kha^Edb, Cha^Edb, Md, Aa^Fda, Aa^Fda, Ha, Ha, Md^Xm, Hhd, Hhd^Es, Hhd, Hhd^Emf, Md, Hhd^Emf, Hhd, Hhd, Hhd, Md, Hhd, Hhd, Md^Xm, Md, Md, Md^Xm, Md, Md, Md, Md, Md, Md, Md, Md, Md, Md^Xm, Md, Md, Md
Md, Ai, Ha^Vhca, Cha, Cha, Cha^Edb, Hhd^Emf, Md, Md, Aa^Fma, Re^Edb, Hhd, Ai, Hhd, Ai, Hhd, Hhd, Hhd, Md, Md, Hhd^Fp, Hhd, Hhd, Md, Md, Md, Md^Xm, Md, Md, Md^Xm, Md, Md, Md, Md, Md, Md, Md, Md, Md, Md, Md
Md, Ai, Md, Hhd^Fp, Hhd^Edb, Hhd^Edb, Md, Md, Aa^Em, Aa^Fma, Gd^Em, Gll^Esa, Gll^Fdw, Ai, Hhd^Fp, Ai, Hhd^Fp, Hhd^Fp, Gd^Fetd, Gll^Esa, Rb, Hhd^Em, Gd^Esa, Hhd, Hhd, Md, Md, Md, Md, Md, Md, Md^Xm, Md, Md, Md, Md, Md, Md, Md, Md, Md
Md, Ai^Esa, Ai^Esa, Md, Gll, Gd^Fdw, Gd^Edb, Aa, Gll^Fdw, Gg, Re, Gd^Edb, Gd, Gd^Fdw, Gll, Hhd^Fp, Gll^Fdw, Gd^Fdw, Gd^Fdw, Rb, Gd^Efm, Gll^Efm, Re, Gll, Hhd, Gll, Md, Md, Md, Md, Md, Md, Md, Md, Md, Md, Md, Md, Md, Md, Md
Md, Md, Hhd^Em, Gll, Hhd^Fp, Gd^Edb, Md, Gd, Md, Gs, Gll^Efm, Re, Hhd^Fp, Gll^Fdw, Md, Gd, Md, Gd^Edb, Md, Rb, Md, Re^Em, Hhd^Fp, Gd^Em, Hhd, Hhd, Md, Md, Gll, Md, Md, Md, Md, Md, Wwrg, Wog, Gll^Fdf, Gll^Fdw, Wwf, Wwf, Md
Md^Xm, Md, Hhd, Gd, Md, Gll^Efm, Md, Md, Md, Gll^Efm, Hhd^Fp, Hhd^Fp, Gll^Efm, Gll^Efm, Md, Md, Md, Hhd^Em, Md^Xm, Md, Md, Md, Re, Re, Re^Em, Hhd^Fp, Hhd, Gll, Rb^Es, Md, Md, Md, Md, Md, Wwrg, Wog, Gll^Fdw, Wwf, Gll^Fdf, Md, Md
Md, Md, Hhd, Re^Em, Md, Hhd, Hhd, Md, Hhd, Hhd, Md, Gd^Es, Md, Gll, Md, Md, Md, Md, Md, Md, Md, Hhd^Emf, Gll^Efm, Gll^Edb, Gd^Esa, Gll^Edb, Gll^Efm, Gd^Ve, Gll^Efm, Md, Gll^Efm, Wwg, Rb^Es, Rb, Gll, Gll^Fdw, Wwg, Wwf, Gll, Gd, Md
Hhd, Hhd^Dr, Md, Md, Md, Md, Hhd, Hhd^Fp, Gd^Fetd, Hhd, Hhd, Hhd, Md, Gd^Edb, Gd^Vhr, Md, Md, Md, Md, Md, Md, Hhd^Em, Hhd^Em, Hhd^Em, Gd^Fetd, Gd^Esa, Cvr, Cha^Edb, Cha^Edb, Hhd^Dr, Gll^Fdw, Rb, Gll^Fdf, Gll^Fdw, Gll^Fdf, Re, Rb, Wwf, Wog, Gll^Es, Md
Gll, Md, Md, Md, Md, Md, Hhd^Fp, Hhd^Fp, Gll, Gll^Efm, Hhd^Em, Md, Md, Gll, Rb, Md, Md, Md, Md, Md, Md, Md, Md, Hhd^Fp, Hhd^Fp, Gd, Cvr, 4 Kha^Edb, Cha^Edb, Gll^Fdf, Gll^Fdf, Gd, Gd^Efm, Gll^Fdf, Gll, Re^Es, Wog, Wog, Gll^Efm, Gll, Rb
Gll, Gll^Emf, Gll, Md, Md, Md, Md, Gd^Edb, Hhd, Hhd^Em, Hhd^Em, Md^Xm, Md, Rb, Gll^Efm, Gd, Md, Md, Md, Md, Md^Xm, Md, Gll, Gll^Efm, Md, Gd, Gll^Fdw, Cvr, Re^Edb, Md, Hhd^Fdf, Gll^Fdf, Gs, Gs, Gll, Gll, Wwf, Wwrg, Rb, Rb, Gd
Wwg, Md, Wwg, Gd^Edb, Gll^Fdw, Gll^Fdw, Re^Efm, Md, Gll, Gll^Edb, Gll, Gll^Dr, Md, Rb, Gll, Gll^Edb, Md, Md, Md, Md^Xm, Md, Md, Gll, Gd^Efm, Gd, Gd^Efm, Gd^Edb, Gd^Edb, Gd^Edb, Re^Edb, Gd^Ve, Hhd, Gs, Gll^Fdw, Gll^Fdw, Re^Es, Wog, Gll, Gll, Gll^Fdf, Gll^Fdf
Wwrg, Wwg, Wwg^Wkf, Wwf, Wwf^Es, Gll^Fmw, Gll^Fmw, Re, Rb, Rb, Gll^Edb, Wwf^Wkf, Md, Md, Md, Gd^Edb, Rb, Gd, Hhd^Efm, Md^Xm, Hhd, Gd^Vhr, Hhd^Efm, Gd^Em, Gd^Em, Gd, Md, Gd, Hhd^Em, Hhd, Gll, Gd^Efm, Gll^Es, Gll^Fdw, Gll, Wwg, Wog, Gll^Fdw, Wog, Md, Gll^Es
Wwf, Wwf^Es, Wwf^Es, Wwf, Wwf, Wwrg, Wog, Rb^Edb, Wwg, Gll^Es, Wwf^Wkf, Wwf^Wkf, Md, Md, Md, Rb^Es, Rb, Hhd^Em, Hhd, Hhd^Fp, Gg, Hhd, Gd^Edb, Gd^Dr, Gll, Md, Gd, Gd, Gd, Gll^Efm, Wwf, Gll^Es, Wwf, Gll, Wog, Wwg, Wwf, Wog, Wwg, Gll^Es, Gll
Wwg, Wwg, Wog, Wog, Wwf^Es, Wwg^Ewf, Wwg, Wog, Wwf^Es, Wwg^Wkf, Wwg^Ewl, Wwrg, Wwrg, Wwrg, Gll, Md, Rb^Es, Gd^Edb, Gs, Gs, Gs, Gs, Gs, Gll, Gd^Efm, Hhd, Gll, Gd^Efm, Gd, Gll, Wwf, Wwf, Wwg, Wwf, Wog, Wwf, Wwf, Gll^Es, Wwf^Es, Rb, Gd^Emf
Gll, Gll^Em, Rb, Wwf, Wwf^Ewl, Wwg^Ewl, Wwg^Es, Wwg^Es, Wwf, Wwf^Ewl, Wog, Wog, Md, Wog, Wog, Gll^Es, Wwg^Ewl, Gd^Edb, Gll^Fp, Md, Md, Gd^Efm, Gd^Efm, Gll, Gd^Edb, Gd^Vhr, Gd^Em, Hhd^Em, Hhd^Emf, Gll^Es, Wwf, Wog, Gll^Es, Wwf, Gll^Es, Wog, Wwrg, Rb^Em, Gd, Gll^Edb, Gd
Hhd^Fdw, Gll^Fdw, Gll^Fdw, Rb, Rb^Efm, Gll^Efm, Gll, Gll^Fdw, Wwf^Es, Md, Wwf, Gll^Es, Md, Wwg^Es, Wwg, Wwf^Es, Wwf, Gll^Fdf, Gll^Fdf, Md, Md, Md, Md, Gll^Fdw, Gd^Edt, Gll, Gll, Hhd, Wog, Wwf, Wog, Wog, Gll, Gd^Es, Md, Md, Gll, Gll, Gll^Efm, Hhd, Md
Md, Hhd^Fdw, Md, Gll, Re^Emf, Re^Vct, Re^Em, Gd^Edb, Gd^Em, Gd, Gll^Fdw, Gd^Em, Gll^Fdw, Wwg^Ewl, Wwf, Wwf, Wwf^Wkf, Wwf^Ewl, Md, Md, Md, Gll^Edb, Hhd^Fdf, Hhd^Fdw, Gll, Wwf, Wwf, Wwrg, Wwg, Wwf, Wwg, Wwrg, Gd, Gll^Fdw, Gd^Emf, Hhd, Hhd, Hhd, Hhd, Hhd, Md^Xm
Hhd, Md, Md, Gll^Fdw, Re^Em, Wwf, Wwf, Re^Edb, Hhd, Hhd, Md, Gd, Gll^Fdw, Wwg^Ewl, Rb^Dr, Wwf^Wkf, Gll^Fmw, Md, Md, Md, Md, Gll^Edt, Gll, Gd, Wwf, Gll^Esa, Wwg, Wwg, Wwf^Ewl, Wwf, Wwrg, Wwrg, Gd^Efm, Gd^Es, Gd, Gd^Efm, Md, Hhd^Fp, Md^Xm, Md^Xm, Md^Xm
Hhd^Fp, Hhd^Em, Hhd^Emf, Hhd^Em, Hhd^Em, Hhd^Fetd, Wwf, Wwg, Wwf, Wwf^Ewl, Md, Gll^Efm, Gll^Efm, Gll^Fdw, Gll^Es, Rb, Gd, Md, Gd^Efm, Md, Hhd^Vhhr, Md, Gll, Wwrg, Wwf, Wwg, Wwg^Es, Wwrg, Wwf^Es, Wwf^Wkf, Wwf^Wkf, Gll, Gd, Hhd, Md, Md, Md^Xm, Md^Xm, Md, Md^Xm, Md
Wwg, Hhd^Fp, Hhd, Md, Md, Wwf, Wog, Wwg, Wwg, Wwrg, Gll^Em, Gll^Efm, Gll^Fdf, Gll^Fdf, Gll^Fdf, Wwf, Gll^Fdf, Gd^Efm, Wwf, Gd^Efm, Gll^Efm, Gll^Edb, Wwg, Wwf, Wwg^Ewl, Rb^Es, Gll, Wwf, Rb^Efm, Wwg, Gll, Gll^Efm, Gll, Hhd, Md, Md, Md, Md, Md, Md, Md
Gd^Fp, Hhd^Fp, Hhd, Md, Hhd^Fp, Md, Wwf, Wwg, Wwf, Wwg, Gd^Edb, Wwrg, Gll^Efm, Gd^Es, Wwf, Gll, Gll^Fdf, Gll^Fdf, Gll^Fdf, Gll^Fdf, Gll^Efm, Wwf, Wwf, Wwg^Ewf, Wwg^Wkf, Wwg^Wkf, Re^Em, Re^Vct, Gd^Efm, Gd, Md, Md, Md, Md, Md, Md, Md^Xm, Md, Md, Md, Md
Gll^Fp, Gll^Fmw, Gd^Fp, Hhd, Gd^Fp, Gll^Emf, Gll, Gll^Edb, Wwf, Wwg, Gd^Fp, Gll, Gll, Gll^Fdf, Wwf^Ewf, Gll^Es, Gll^Fdf, Re, Gll^Es, Gd, Gd^Efm, Re^Edb, Gll^Es, Wwf, Wwrg, Wog, Gll^Esa, Gd^Efm, Hhd^Em, Md, Md, Md^Xm, Md, Md, Md, Md^Xm, Md, Md, Md^Xm, Md^Xm, Md^Xm
Wwg, Gll, Wog, Wwrg, Wwg, Gll^Fmw, Wwg, Wwg, Wwf, Wwf, Wwf, Wwg, Gll^Es, Gll, Wwf, Wwf, Gll, Gd^Es, Wog, Wwf, Wwf, Rb, Gll, Wwrg, Wog, Wog, Gll, Hhd, Hhd^Em, Md, Hhd^Fp, Md, Hhd^Emf, Hhd^Edb, Hhd^Edb, Md^Xm, Md^Xm, Md, Md, Md^Xm, Md
Wwg, Wwg, Wwg, Wwg, Wwg, Wwg, Wwg, Wwg, Gll, Gll, Wwf, Wwg, Wwg, Wwf, Wwf, Wwg, Wwg, Wog, Wwf, Wwf, Wwf, Gll^Es, Wwg, Wwrg, Gll, Gll^Efm, Rb^Edb, Hhd, Md, Hhd^Esa, Hhd^Esa, Hhd^Em, Md, Md, Md, Hhd, Md, Md, Md, Md, Md
Gll^Fp, Wwg, Gll^Fp, Gll^Em, Gll^Efm, Wwf, Gd^Fp, Rb, Rb, Rb^Emf, Gll^Edb, Wwg^Es, Gll^Edb, Wog, Wwf, Wwf, Wwf, Wwf, Wwg, Wwf, Gll^Efm, Wwf, Gll^Emf, Wwg, Gll, Wwg, Wwf, Rb^Edb, Wwrg, Md, Md, Md, Md, Md, Gll^Es, Hhd^Vhhr, Md, Md, Md, Md, Md^Xm
Gd^Fp, Gll^Fp, Gll^Fdw, Gd^Fp, Cvr, Gd^Fp, Gd^Fetd, Gd^Fp, Gll^Fdf, Gll^Edb, Gd^Fp, Gd, Gll^Efm, Wwrg, Rb^Es, Wwf^Wkf, Gll^Es, Rb^Es, Wwg, Gll^Efm, Wwf, Rb, Rb^Es, Wwg, Gd^Fdw, Gll, Gll, Wwf, Wwf, Wwf, Wwf, Md, Md, Gd^Es, Gll, Md, Gd, Hhd^Edb, Md, Md^Xm, Md
Gll^Em, Gd^Ve, Gll^Fp, Cvr, 3 Kvr, Cvr, Gd^Fp, Gd^Dr, Gll^Ve, Gll^Fmw, Gll^Fdw, Gd^Fp, Wwrg, Rb, Gll^Fdw, Rb, Gs, Gg, Wwrg, Gll, Gll, Gd^Fdw, Rb^Efm, Rb^Es, Gd^Emf, Gd^Emf, Wwf, Wwf, Gll^Es, Wwf, Gll, Gll^Es, Gd, Gd, Gll^Edb, Md, Gd^Es, Hhd^Fp, Hhd^Edb, Hhd, Md
Gll^Fp, Gll^Fdw, Gd^Fp, Cvr, Cvr, Cvr, Gll^Fp, Gll^Fdw, Wog, Wwf, Gll^Fdw, Wwrg, Gll^Fp, Gd^Fp, Gd^Fp, Gd^Em, Gll, Wwg, Gll^Es, Wwrg, Rb, Gd^Efm, Aa^Esa, Gd, Gd^Ve, Gll^Edb, Gll^Edb, Gd^Esa, Re, Gll^Esa, Rb, Hhd, Md, Md, Hhd, Gll, Hhd, Hhd, Hhd, Hhd, Hhd
Gll^Fp, Gll^Fdw, Gll^Fmw, Gd^Fp, Gll^Fdf, Gll^Fp, Wwf^Wkf, Wwf^Wkf, Gll^Fp, Wog, Wwg^Es, Wwrg, Gll^Fdw, Gd^Fp, Wwf, Gll^Emf, Rb, Rb, Gll^Dr, Wwrg, Wwg, Gll, Aa, Aa^Efm, Ai^Esa, Ai, Gd^Efm, Gd^Esa, Gd, Re, Re^Em, Rb, Rb, Md, Gll, Gll, Gll^Esa, Gd, Gs, Gll, Hhd
Md, Gll^Fdf, Md, Rb, Rb^Efm, Gll^Fdf, Md, Md, Gd^Fp, Rb, Rb^Efm, Gll^Fp, Gd^Fp, Gll^Fp, Wwg, Gll^Em, Wwf, Gd^Vhr, Gll^Es, Wwrg, Gll^Fdw, Gll^Esa, Aa, Md, Md, Ai^Esa, Hhd, Gll^Em, Md, Gll^Emf, Rb, Gll, Gd, Hhd, Gd^Efm, Gd^Efm, Gs, Gs, Ha, Gll, Gd
Md, Md, Md^Em, Gd^Fp, Rb, Gll^Fdf, Gd^Fp, Gd^Fetd, Gd, Gll^Dr, Gd^Esa, Gd^Fp, Wwrg, Wog, Gll^Em, Gll^Efm, Gd, Gd, Rb^Efm, Gll^Es, Gll^Esa, Gd, Aa^Esa, Md, Md^Xm, Md, Md, Hhd, Hhd, Md, Md, Gll^Es, Gll, Gd^Esa, Gd, Re, Re, Gg, Ha, Ai^Esa, Ai
Gll^Fp, Wwf^Es, Wog, Gd^Fp, Wwrg, Gll, Gll^Efm, Gd, Gs, Gs, Gg, Gd^Fp, Gll, Gll^Efm, Gd, Gd, Re^Em, Re, Re, Rb^Efm, Gll, Aa^Esa, Md, Md, Md^Xm, Md^Xm, Md, Md, Hhd^Fp, Hhd^Fp, Md, Md, Md, Gd, Gd^Es, Gd^Fdw, Re^Efm, Gll^Efm, Ha^Vhca, Ha^Esa, Ha
Gll, Gd^Fp, Gll^Fdw, Wwrg, Gll^Fp, Rb, Gll^Efm, Wwrg, Gll^Fdf, Gll^Fdw, Gll^Fmw, Gll, Re, Gll^Efm, Md, Rb, Gll^Efm, Gll, Re^Em, Rb, Md, Md, Md, Md, Hhd^Emf, Md, Md, Hhd^Em, Hhd^Fp, Md, Md^Xm, Md, Ha, Aa^Fma, Aa^Fmw, Gd^Fdw, Aa, Ha, Ha, Ha^Esa, Ha
Md, Gll^Fdw, Md, Gd^Fp, Wwf, Gll^Fdw, Gd^Efm, Re, Gll, Wwg^Ewl, Re^Es, Re, Wwg^Es, Re, Md, Rb, Gll^Efm, Hhd, Hhd, Re, Gd^Ve, Md, Hhd, Md, Hhd^Em, Md^Xm, Hhd^Emf, Md^Xm, Hhd^Es, Md, Md^Xm, Ha^Vhca, Ha, Aa^Fdw, Aa^Fda, Gd^Ecf, Cea^Edb, Cea^Edb, Cea, Aa, Aa
Md, Md^Xm, Md, Hhd, Gd^Fetd, Gll^Fdf, Gd, Rb, Gll^Es, Wwg, Wog, Wwg, Wwg, Md, Wwf^Wkf, Md, Md, Md, Md, Hhd, Hhd, Hhd, Gll, Hhd, Hhd, Md, Hhd^Em, Hhd^Em, Ai, Hhd, Hhd, Ha, Aa^Fma, Md, Md, Md, Cea, 1 Kea, Cea, Aa^Fma, Ai
Hhd, Md, Hhd^Em, Hhd, Re^Edb, Re^Edb, Rb^Emf, Rb, Wwf, Gll^Efm, Gll, Wog^Ewf, Wog, Wwf, Wwg, Md, Hhd, Md^Xm, Hhd, Hhd, Hhd, Hhd, Gll^Esa, Gll, Aa^Fmw, Hhd, Ai, Ai, Ai, Ai, Gll^Esa, Re^Edb, Aa^Fma, Md, Md, Hhd^Emf, Hhd, Cea, Hhd^Fp, Ha^Vhca, Ai
Hhd^Fp, Hhd^Emf, Hhd^Fp, Gll^Fdw, Gll, Gll^Em, Gll, Wwf, Wwg^Ewl, Gll^Efm, Wog, Gll^Es, Wwf, Wwrg, Re, Gll^Es, Gll^Fdw, Hhd, Gll, Gll, Gll^Efm, Rb, Rb, Gd^Fetd, Gd^Fdw, Aa^Fmw, Aa^Fmw, Aa, Gd^Fdw, Gll^Fdw, Ai, Gd^Em, Gd^Em, Aa, Aa, Md, Gd^Fdw, Hhd, Md, Md, Ai
Hhd^Fp, Md, Gll^Fp, Gd, Gll, Wwrg, Wwg, Wwg, Wwg, Wwg^Ewl, Wwg, Gll, Gll^Efm, Gd, Gd, Re, Gll, Gll, Gll, Gd, Gd, Gd^Efm, Rb, Gd^Fdw, Gd^Edb, Gll^Fdw, Gd, Gll, Gll^Fdw, Gd, Gll, Gll, Gll, Gll^Fdw, Gd, Gd, Gd, Ai, Ai, Ai, Md
