Ha, Ai, Ha^Esa, Ha, Gd, Md, Gd^Fdw, Gd^Esa, Gd^Esa, Md, Md, Md, Hhd^Fp, Hhd, Ms, Ms, Ms, Md^Xm, Md^Xm, Ms, Ms, Ms, Ms, Ms, Md^Xm, Md^Xm, Md, Md, Md^Xm, Md, Ms, Md, Md, Ms, Ms, Md^Xm, Md, Ms, Ms, Ms, Ms
Ha, Ha^Esa, Ha, Ms, Ms, Re^Efm, Gd^Fdw, Gd, Aa^Fma, Ms, Ms, Md, Ms, Hhd^Fp, Hhd^Em, Ms, Ms, Md, Md, Md^Xm, Md, Ms, Md, Md^Xm, Md, Md, Md^Xm, Md^Xm, Md, Md, Md^Xm, Md^Xm, Md, Md, Md, Md, Md, Md, Md, Ms, Ms
Ha, Ha, Aa^Es, Ms, Rr, Md, Md, Aa^Fmw, Aa^Fdw, Ha, Ha^Vhca, Ms, Ms, Hhd^Fp, Ms^Xm, Ms^Xm, Ms, Hhd^Emf, Ms, Md, Md, Md^Xm, Ms, Md, Hhd, Md, Md, Md, Md, Md, Md^Xm, Md, Md, Md, Md, Ms, Ms, Md, Md, Md, Ms
Ha, Aa, Aa^Fma, Ch, 2 Kha^Ii, Cha^Ii, Ms, Aa^Fda, Aa^Fda, Ha, Ha, Md^Xm, Hhd, Hhd^Es, Hhd, Ms, Ms, Hhd^Emf, Hhd, Hhd, Hhd, Ms, Hhd, Hhd, Md, Md^Xm, Md^Xm, Md, Ms, Md, Md, Md, Md^Xm, Md, Ms, Ms, Md, Md^Xm, Md^Xm, Md, Ms
Hhd, Ai, Ha^Vhca, Cha, Cha, Cha, Hhd^Emf, Md, Ms, Aa^Fma, Re^Edb, Hhd, Ai, Hhd, Ai, Hhd, Hhd, Hhd, Ms^Xm, Md^Xm, Hhd^Fp, Hhd, Hhd, Ms, Ms^Xm, Md, Md, Md^Xm, Md^Xm, Md, Md, Md, Md, Md, Md, Md^Xm, Md, Md, Md, Md, Md
Hhd, Ai, Md^Xm, Hhd^Fp, Hhd, Hhd, Md, Ms, Aa^Em, Aa^Fma, Gd^Em, Gll^Esa, Re, Ai, Hhd^Fp, Ai, Hhd^Fp, Hhd^Fp, Gll^Em, Gll^Esa, Rb, Hhd^Em, Gd^Esa, Hhd^Fp, Hhd^Fp, Ms, Ms, Md, Md^Xm, Md, Md, Md, Hhd, Hhd, Md^Xm, Md, Md, Md, Md, Md, Md
Hhd, Ai^Esa, Ai, Md, Gll, Gd^Fdw, Gd, Aa, Gll^Fdw, Gd, Re, Gll, Gd^Ve, Rb, Md, Hhd^Fp, Gd^Efm, Gd, Gd, Rb, Gd^Efm, Gll^Efm, Re, Gll, Hhd^Fp, Aa^Feta, Ms, Md, Md, Md^Xm, Md, Md, Hhd, Md, Md, Md^Xm, Md^Xm, Md, Ms, Ms, Ms
Hhd, Hhd, Hhd^Em, Gll, Hhd^Fp, Gd, Rb, Gd, Rb, Gd, Gll^Efm, Re, Re, Re, Rb, Gd, Gd^Efm, Gd^Edb, Gd^Efm, Rb, Re, Re^Em, Gd^Em, Gd^Em, Hhd, Hhd, Ms, Ms, Gll, Md, Md, Md, Hhd^Fp, Hhd^Fp, Md, Md, Md, Md^Xm, Md, Md, Ms
Md, Md^Xm, Md, Gd, Hhd, Gll^Efm, Md^Xm, Rb, Md, Gll^Efm, Rb, Rb, Gll^Efm, Gll^Efm, Gd, Gd, Hhd, Hhd^Em, Md, Gd^Efm, Hhd, Rb, Re, Gd^Ve, Re^Em, Hhd^Fp, Hhd, Gll, Rb^Es, Hhd^Fp, Hhd^Fp, Hhd^Fp, Hhd, Md, Md, Md, Md, Md, Ms, Ms, Ms
Md, Md, Md, Md, Md, Md, Md^Xm, Md, Md, Md, Md, Gd^Es, Md, Md, Md, Hhd, Ms^Xm, Md, Md, Hhd, Hhd^Fp, Hhd^Emf, Gll^Efm, Gll, Gd^Esa, Gll, Gll^Efm, Gd^Ve, Gll^Efm, Hhd, Gll^Efm, Hhd, Rb^Es, Hhd, Gll, Md, Md, Md, Md, Md, Ms
Md, Md, Md, Md, Md^Xm, Md^Xm, Md, Md^Xm, Md^Xm, Md, Md, Md, Md, Md, Md, Md, Md, Md, Md, Md, Md, Hhd^Em, Hhd^Em, Gd^Efm, Gll^Efm, Gd^Esa, Cvr, Cha^Edb, Cha^Ii, Gll, Gll^Fdw, Rb, Gll^Fdf, Gll^Fdw, Gll^Fdf, Re, Rb, Md, Md^Xm, Ms, Ms
Md^Xm, Md, Md^Xm, Md^Xm, Md, Md^Xm, Md, Md, Md, Md^Xm, Md^Xm, Md, Md, Md, Ms^Xm, Md, Ms, Md, Md, Md, Md, Md, Hhd^Fp, Hhd^Fp, Gd^Efm, Gd, Cvr, 4 Kha^Ii, Cha^Edb, Gll^Fdf, Gll^Fdf, Gd, Gd^Efm, Gll^Fdf, Gll, Re^Es, Hhd, Md, Md, Md, Ms
Md, Md^Xm, Md, Hhd, Hhd, Md, Md, Md, Hhd, Md, Md, Md^Xm, Md^Xm, Ms, Ms, Ms^Xm, Md^Xm, Md, Md, Md, Md, Hhd^Fp, Gll, Gll^Efm, Md, Gd, Gll^Fdw, Cvr, Re, Ms, Hhd^Fdf, Gll^Fdf, Gd, Gd, Gll, Gll, Hhd^Fp, Md, Md, Ms, Ms
Wwf, Md, Wwg, Gd^Em, Gll^Fdw, Gll^Fdw, Re^Efm, Hhd, Gll, Hhd, Hhd, Md, Md, Md^Xm, Md^Xm, Md^Xm, Md, Md^Xm, Md^Xm, Md, Md^Xm, Hhd^Fp, Gll, Gd^Efm, Gd, Gd^Efm, Gd, Gd, Gll, Re, Gd^Ve, Hhd, Gd, Gll^Fdw, Gll^Fdw, Re^Es, Md^Xm, Hhd, Hhd, Md, Md
Wwrg, Wwg, Wwg^Wkf, Wwf, Wwf^Es, Gll^Fmw, Gll^Fmw, Re, Rb, Rb, Hhd, Wwf^Wkf, Hhd, Hhd, Md, Md, Md, Md, Hhd, Md^Xm, Hhd, Gd^Ve, Hhd, Gd^Em, Hhd, Hhd, Ms, Gll, Hhd^Fp, Hhd^Fp, Gll, Gd^Efm, Gll^Es, Gll^Fdw, Gll, Md, Md, Md^Xm, Md^Xm, Hhd, Hhd
Wwf, Wwf^Es, Wwf^Es, Wwf, Wwf, Wwrg, Wog, Rb^Edb, Wwg, Hhd, Wwf^Wkf, Wwf^Wkf, Hhd, Md, Md, Md, Hhd^Fp, Hhd^Fp, Hhd^Fp, Hhd^Fp, Gll, Hhd^Fp, Gll, Gll^Efm, Hhd, Md, Gd, Gd, Gd, Gll^Efm, Hhd, Gll^Es, Hhd, Gll, Md^Xm, Hhd^Fp, Hhd, Md, Md, Md^Xm, Md^Xm
Wwg, Wwg, Wog, Wog, Wwf^Es, Wwg^Ewf, Chw, Wog, Wwf^Es, Wwg^Wkf, Wwg^Ewl, Wwrg, Wwrg, Wwf, Gll, Hhd^Fp, Rb^Es, Gd, Gd, Gd, Gd, Gll, Wwg^Ewl, Gll, Gd^Efm, Hhd^Fp, Gll, Gd^Efm, Gd, Hhd^Fp, Ms, Ms, Md, Md, Md, Md^Xm, Md, Md, Md, Ms^Xm, Md
Gll, Gll^Em, Rb, Wwf, Wwf^Ewl, Wwg^Ewl, Wwg^Es, Wwg^Es, Wwf, Wwf^Ewl, Wog, Wog, Chw, Wog, Wog, Gll^Es, Wwf^Ewl, Gll, Gll^Fp, Hhd, Hhd, Gd^Efm, Gd^Efm, Gll, Gd, Gd^Ve, Gd^Em, Hhd, Hhd^Emf, Ms, Md^Xm, Md^Xm, Md, Md, Md, Md, Md, Md, Ms, Md, Md^Xm
Hhd^Fdw, Gll^Fdw, Gll^Fdw, Rb, Rb^Efm, Gll^Efm, Gll, Gll^Fdw, Wwf^Es, Md, Wwf, Gll^Es, Wwg, Wwg^Es, Wwf, Wwf^Es, Wwf, Gll^Fdf, Gll^Fdf, Hhd, Ms, Wwf, Wwf, Gll^Fdw, Gd, Gll, Hhd^Fp, Hhd^Fp, Hhd, Md, Md, Md, Md, Md, Md^Xm, Md^Xm, Md^Xm, Ms, Ms^Xm, Ms, Md
Ms, Hhd^Fdw, Ms, Gll, Re^Emf, Ms, Re^Em, Gd^Em, Gd^Em, Gd, Gll^Fdw, Gd^Em, Gll^Fdw, Wwg^Ewl, Chw, Khw, Chw, Wwf^Ewl, Hhd, Ms, Md, Md, Md, Wwg^Wkf, Md, Md, Md, Hhd, Md^Xm, Ms, Ms, Md, Ms^Xm, Ms^Xm, Md^Xm, Md, Md, Md^Xm, Md, Ms^Xm, Ms^Xm
Hhd, Ms, Ms, Gll^Fdw, Re^Em, Gll, Ms^Xm, Re^Edb, Hhd^Fp, Hhd^Fp, Ms, Gd, Gll^Fdw, Wwg^Ewl, Gll^Efm, Chw, Gll^Fmw, Hhd, Md^Xm, Md, Md^Xm, Md^Xm, Ms, Wwg, Wwg^Ewl, Md, Md, Md^Xm, Md, Md^Xm, Ms^Xm, Ms, Md^Xm, Md, Md, Md, Md, Md, Md, Ms, Ms
Hhd^Fp, Hhd^Em, Hhd^Emf, Hhd^Em, Hhd^Em, Hhd, Hhd^Fp, Hhd^Fp, Md, Md, Md, Gll^Efm, Gll^Efm, Gll^Fdw, Gll^Es, Rb, Gd, Hhd, Gd, Md, Gd^Ve, Hhd, Hhd, Ms, Ms^Xm, Md, Md, Md, Md, Md, Md, Md^Xm, Md, Md, Hhd^Em, Hhd, Md^Xm, Md^Xm, Md, Md, Ms
Wwg, Hhd^Fp, Hhd, Ms, Ms, Hhd, Md, Md, Md, Md, Md^Xm, Gd^Ve, Wwf^Wkf, Wwf, Wwrg, Wwf, Gll^Fdf, Gd^Efm, Wwf^Wkf, Gd^Efm, Gll^Efm, Gll^Edb, Hhd^Fp, Ms, Md, Md, Md^Xm, Ms, Md, Md, Md, Md, Md, Hhd^Emf, Hhd, Md, Md, Md, Ms, Ms, Md
Gd^Fp, Hhd^Fp, Hhd, Ms, Hhd^Fp, Ms^Xm, Ms^Xm, Md, Md, Md^Xm, Hhd, Wwf, Gll^Efm, Gd^Es, Gll^Fdf, Gd^Ve, Gll^Fdf, Gll^Fdf, Gll^Fdf, Gll^Fdf, Gll^Efm, Wwf^Wkf, Wwf, Hhd, Hhd^Fp, Md, Md, Md^Xm, Md, Md, Md^Xm, Md, Md, Hhd^Em, Md, Md, Md, Md, Md, Md, Md
Gll^Fp, Gll^Fmw, Gd^Fp, Hhd, Gd^Fp, Gll^Emf, Gll, Gll^Edb, Wwg, Md, Gd^Fp, Gll, Gll, Gll^Fdf, Ms^Xm, Gll^Es, Hhd, Re, Gll^Es, Gd, Gll^Fdf, Re^Edb, Gll^Es, Wwg^Ewl, Chw, Wwf^Wkf, Gll^Esa, Md, Hhd^Em, Ms, Md, Md, Ms, Md, Md, Md, Md, Md^Xm, Md, Md, Ms^Xm
Ms, Gll, Md, Md, Md, Gll^Fmw, Wwg, Wwg, Md, Md^Xm, Gll^Fdf, Wwg, Gll^Es, Hhd, Ms, Ms, Ms^Xm, Gd^Es, Wog, Wwf, Wwf^Ewl, Rb, Gll, Wwf, Wwf^Wkf, Wwf, Gll, Hhd, Hhd^Em, Md, Hhd^Fp, Ms^Xm, Hhd^Emf, Hhd^Edb, Hhd^Edb, Md, Md, Md, Ms, Ms^Xm, Ms
Md^Xm, Md^Xm, Md, Md, Ms, Md, Md^Xm, Md^Xm, Gll, Gll, Gll^Fdf, Wwrg, Wwg^Wkf, Hhd^Fp, Hhd, Ms^Xm, Hhd^Fp, Ms, Ms^Xm, Wwf, Wwf^Ewl, Gll^Es, Wwf, Wwf, Gll, Gll^Efm, Gll, Hhd, Wwf, Hhd^Esa, Hhd^Esa, Hhd^Em, Md^Xm, Ms, Ms, Hhd, Wwg^Ewl, Md, Md, Md, Ms
Gll^Fp, Md, Gll^Fp, Gll^Em, Gll^Efm, Wwf, Gd^Fp, Rb, Rb, Rb^Emf, Gll^Edb, Wwg^Es, Gll, Wog, Wwf, Hhd, Hhd^Fp, Md, Md^Xm, Ms, Md^Xm, Wwf, Hhd^Emf, Hhd^Fp, Gll, Wwf^Ewl, Wwf, Gll, Wwrg, Wwf, Wwg, Md, Md, Md, Gll^Es, Gd^Ve, Wwg^Ewl, Md^Xm, Md, Md, Md
Gd^Fp, Gll^Fp, Gll^Fdw, Gd^Fp, Cvr, Gd^Fp, Rb, Gd^Fp, Gll^Fdf, Gll, Gd^Fp, Gd, Gll^Efm, Wwrg, Rb^Es, Hhd^Fp, Hhd, Hhd, Hhd^Fp, Md, Md, Md^Xm, Md^Xm, Hhd^Em, Gd^Ve, Gll, Gll, Chw, Wwf, Khw, Chw, Wwg^Ewl, Wwf^Ewl, Gd^Es, Gll, Wwg, Gd, Hhd, Ms, Md, Ms
Gll^Em, Gd^Ve, Gll^Fp, Cvr, 3 Kvr^Ii, Cvr^Ii, Gd^Fp, Rb, Gd^Ve, Gll^Fmw, Gll^Fdw, Gd^Fp, Wwf, Rb, Gll^Fdw, Rb, Gd, Gd, Hhd^Fp, Ms, Aa^Feta, Md, Md^Xm, Ms, Hhd, Gd^Emf, Wwf^Ewl, Wwf, Gll^Es, Chw, Gll, Chw, Gd, Gd, Gll, Wwg^Wkf, Gd^Es, Hhd^Fp, Hhd, Hhd, Hhd
Gll^Fp, Gll^Fdw, Gd^Fp, Cvr, Cvr, Cvr, Gll^Fp, Gll^Fdw, Wog, Wwf, Gll^Fdw, Wwrg, Gll^Fp, Gd^Fp, Gd^Fp, Gd, Gll, Wwg, Hhd, Hhd^Em, Ms, Md, Md^Xm, Ms^Xm, Hhd, Gll^Edb, Gll, Gd^Esa, Re, Gll^Esa, Rb, Hhd, Ms^Xm, Md, Hhd, Gll, Md, Hhd, Hhd^Efm, Hhd, Hhd
Gll^Fp, Gll^Fdw, Gll^Fmw, Gd^Fp, Gll^Fdf, Gll^Fp, Wwf^Wkf, Wwf^Wkf, Gll^Fp, Wog, Wwf, Wwrg, Gll^Fdw, Gd^Fp, Wwf, Gll^Emf, Rb, Rb, Hhd^Fp, Ms, Hhd^Emf, Ms^Xm, Hhd^Em, Md, Hhd, Wwf, Gd^Efm, Gd^Esa, Gd, Re, Re^Em, Rb, Rb, Ms, Gll^Fdf, Gll, Gll^Esa, Gd, Gd, Gll, Hhd
Ms, Aa^Feta, Ms^Xm, Rb, Rb^Efm, Gll^Fdf, Md^Xm, Ms, Gd^Fp, Rb, Rb^Efm, Gll^Fp, Gd^Fp, Gll^Fp, Wwg, Gll^Em, Wwf, Gd^Ve, Gll^Es, Hhd^Fp, Hhd^Em, Ms, Hhd^Fp, Hhd, Hhd^Fp, Wwf^Wkf, Hhd, Gll^Em, Gll^Em, Gll^Fdf, Rb, Gll, Gll^Fdf, Hhd, Gd^Efm, Gd^Efm, Gd, Gd, Ha, Gll, Gd
Ms, Ms, Md^Xm, Gd^Fp, Rb, Gll^Fdf, Gd^Fp, Rb^Efm, Gd, Rb, Gd^Esa, Gd^Fp, Wwrg, Wog, Gll^Em, Gll^Efm, Gd^Fp, Gd, Rb^Efm, Gll^Es, Gll^Esa, Hhd^Es, Wwg^Wkf, Wwg, Wwg, Wwf^Wkf, Wwf, Hhd^Fp, Re, Gd, Gd, Gll^Es, Gll, Gd^Esa, Gd, Re, Re, Gd, Ha, Ai^Esa, Ai
Gll^Fp, Wwf^Es, Wog, Gd^Fp, Wwrg, Gll, Gll^Efm, Gll^Fp, Gll, Gd, Gd, Gd^Fp, Gll, Gll^Efm, Gd^Ve, Gd^Fp, Re^Em, Re, Re, Rb^Efm, Gll^Fp, Wwg, Wwf^Ewl, Wwf^Ewl, Wwf, Wwf, Hhd^Fp, Re, Gll^Fdf, Re, Gd, Gll, Gd, Gd, Gd^Es, Gd^Fdw, Re^Efm, Gll^Efm, Ha^Vhca, Ha, Ha
Gll, Gd^Fp, Gll^Fdw, Wwrg, Gll^Fp, Rb, Gll^Efm, Wwrg, Gll^Fdf, Gll^Fdw, Gll^Fmw, Gll, Re, Gll^Efm, Re, Rb, Gll^Fp, Gll, Re^Em, Rb, Rb, Wwg^Wkf, Rb, Rb, Hhd, Hhd, Hhd^Fp, Gd^Ve, Gd, Gd, Gll^Edb, Gd, Aa^Fmw, Aa^Fma, Aa^Fmw, Gd^Fdw, Aa, Ha, Ha, Ha^Esa, Ha
Ms, Gll^Fdw, Ms^Xm, Gd^Fp, Wwf, Gll^Fdw, Gd^Efm, Re, Gll, Wwg^Ewl, Re^Es, Re, Wwg, Re, Re, Rb, Gll^Fp, Gd, Gll^Fdw, Re, Gll^Fdw, Rb, Wog, Wog, Wog, Hhd^Fp, Wwf, Gll, Gll, Gd^Esa, Gd^Esa, Gd^Fdw, Aa^Fmw, Aa^Fdw, Aa^Fda, Aa, Cea, Cea, Cea, Aa, Aa
Md, Md^Xm, Md, Hhd, Rb^Efm, Gll^Fdf, Gd, Rb, Gll^Es, Wwg, Wog, Wwg, Wwg^Wkf, Gll^Fp, Wwf^Wkf, Gll^Fp, Gd, Gd, Gll^Fdw, Gd^Fp, Gll^Fp, Re, Gll, Wwf, Wwf^Wkf, Wwf, Gll, Gll, Ai, Gll, Gll, Aa^Fmw, Aa^Fma, Ms, Ms, Ms, Cea, 1 Kea, Cea, Aa^Fma, Ai
Hhd, Md, Hhd^Em, Hhd, Re, Re, Rb^Emf, Gll^Fp, Wwf, Gll^Efm, Gll, Wog^Ewf, Wog, Chw, Wwg, Gll, Gll^Fdw, Gll^Fdw, Gd, Gd^Fp, Gll^Fp, Re, Gll^Esa, Gll, Aa^Fmw, Gll, Ai, Ai, Ai, Ai, Gll^Esa, Re^Edb, Aa^Fma, Ms^Xm, Md, Hhd^Emf, Hhd^Ecf, Cea, Hhd^Fp, Ha^Vhca, Ai
Hhd^Fp, Hhd^Emf, Hhd^Fp, Gll^Fdw, Gll^Fp, Gll^Em, Gll, Wwf, Wwg^Ewl, Gll^Efm, Wog, Gll^Es, Wwf, Wwrg, Re, Gll^Es, Gll^Fdw, Gd, Gll, Gd, Gll^Efm, Rb, Rb, Rb^Efm, Gd^Fdw, Aa^Fmw, Aa^Fmw, Aa, Gd^Fdw, Gll^Fdw, Ai, Gd^Em, Gd, Aa, Aa, Md, Gd^Fdw, Hhd, Ms, Md, Ai
Hhd^Fp, Ms, Gll^Fp, Gd, Gll, Wwrg, Wwg, Wwg, Wwg, Wwg^Ewl, Wwg, Gll, Gll^Efm, Gd, Gd, Re, Gll, Gll, Gll, Gd, Gd, Gd^Efm, Rb, Gd^Fdw, Gd^Edb, Gll^Fdw, Gd, Gll, Gll^Fdw, Gd, Gll, Gll, Gll, Gll^Fdw, Gd, Gd, Gd, Ai, Ai, Ai, Ms
