Xu, Xu, Xu, Xu, Xu, Xu, Xu, Xu, Xu, Xu, Xu, Xu, Xu, Xu, Xu, Xu, Xu, Xu, Xu, Xu, Xu, Xu, Xu, Xu, Xu, Xu, Xu, Xu, Xu, Xu, Xu
Xu, Xu, Xu, Xu, Xu, Xu, Xu, Xu, Xu, Xu, Xu, Xu, Uh, Uu, Uh^Emf, Xu, Uh, Xu, Uu^Edb, Ur^Edb, Ur^Edb, Xu, Uh, Xu, Xu, Xu, Xu, Xu, Xu, Xu, Xu
Xu, Xu, Xu, Xu, Xu, Xu, Xu, Xu, Xu, Xu, Xu, Uu, Cud, Uh^Em, Uu^Em, Ur^Edb, Ur^Edb, Ur^Ii, Isa, Isa, Isa, Uu^Edb, Uh, Cud, Cud^Ii, Xu, Xu, Xu, Xu, Xu, Xu
Wo, Xu, Xu, Xu, Xu, Xu, Xu, Xu, Xu, Xu, Xu, Uh, Uh^Ii, Uh, Uu, Uu, Xu, Isa, Cud, Cud, Ur, Uu^Ii, Ur, Cud, Cud, 2 Kud, Xu, Xu, Xu, Xu, Xu
Ww, Wo, Wwr, Xu, Xu, Xu, Xu, Xu, Xu, Xu, Xu, Uu^Edb, Isa, Ur^Ii, Uu^Vud, Xu, Uu^Vud, Xu, Isa, Uu, Uu^Ii, Ur^Ii, Uh, Uh, Uh, Cud^Es, Xu, Xu, Xu, Xu, Xu
Qxua, Ww, Uh, Uu, Xu, Xu, Xu, Xu, Xu, Xu, Xu, Xu, Uh, Ur, Uh, Xu, Uh, Ur^Edb, Isa, Isa, Xu, Uh, Xu, Xu, Ur, Cud^Es, Xu, Xu, Xu, Xu, Xu
Xu, Qxua, Uh, Ur, Xu, Xu, Xu, Xu, Xu, Xu, Xu, Xu, Qxu, Qxu^Bs|, Qxu, Xu, Uh, Isa, Uh^Emf, Uh^Em, Xu, Xu, Xu, Ur^Emf, Uu^Vud, Uh, Xu, Xu, Xu, Xu, Xu
Xu, Xu, Isa, Isa, Xu, Xu, Xu, Xu, Xu, Xu, Xu, Xu, Uu, Isa, Isa, Qxu, Qxu^Bs/, Ur, Xu, Xu, Xu, Xu, Ur^Em, Isa^Em, Isa, Uh, Xu, Xu, Xu, Xu, Xu
Xu, Xu, Isa, Ww, Xu, Xu, Xu, Xu, Xu, Xu, Wwr, Uh, Ur, Uh, Isa, Isa, Uh, Qxu, Xu, Xu, Xu, Ur, Isa, Isa, Xu, Xu, Xu, Xu, Xu, Xu, Xu
Xu, Xu, Uu, Uh, Qxua, Xu, Xu, Xu, Uh, Uh, Ur, Uu, Ur, Uh, Uu^Vud, Isa, Ur, Qxu, Ur, Uu^Vud, Uu^Ii, Uu, Uh, Uh, Xu, Xu, Xu, Xu, Xu, Xu, Xu
Qxua, Xu, Uh, Isa, Qxua, Xu, Xu, Uu^Vud, Ur, Isa, Isa, Uh, Uh, Uu, Xu, Isa, Xu, Qxu^Bs\, Ur, Uu^Edb, Uh, Uh^Ii, Uh, Xu, Xu, Xu, Xu, Xu, Xu, Xu, Xu
Wo, Qxua, Isa, Ur, Qxua, Qxua, Qxua, Qxua, Uu, Ww, Isa, Uu, Qxua, Xu, Xu, Xu, Qxu, Qxu, Uu, Uh, Uh^Emf, Uh, Xu, Xu, Xu, Xu, Xu, Xu, Xu, Xu, Xu
Uh, Uh, Uh, Uu, Ur, Ww, Uh, Uu, Uu, Uh, Isa, Qxua, Qxua, Xu, Xu, Xu, Xu, Xu, Xu, Uh^Emf, Xu, Xu, Xu, Xu, Xu, Xu, Xu, Xu, Xu, Xu, Xu
Wwr, Uu^Vud, Uh, Uh, Isa, Uu, Uh, Uu^Vud, Uh, Isa, Ww, Qxua, Xu, Xu, Xu, Xu, Xu, Xu, Xu, Xu, Xu, Xu, Xu, Xu, Xu, Xu, Xu, Xu, Xu, Xu, Xu
Uh, Uu, Isa, Isa, Xu, Ur, Wwr, Ur, Isa, Isa, Qxua, Qxua, Xu, Xu, Xu, Xu, Xu, Xu, Xu, Xu, Xu, Xu, Xu, Xu, Xu, Xu, Xu, Xu, Xu, Xu, Xu
Xu, Uh, Uu^Vud, Wwr, Xu, Uh, Uh, Uu, Isa, Isa, Uu, Uu, Uh, Uu^Vud, Ww, Xu, Wo, Ww, Xu, Xu, Xu, Xu, Xu, Xu, Xu, Xu, Xu, Xu, Xu, Xu, Xu
Xu, Xu, Xu, Xu, Ww, Uh, Ur, Isa, Uh, Uh, Uh, Ur, Isa, Isa, Uu, Wwr, Qxua, Uu, Uu, Xu, Xu, Xu, Xu, Xu, Xu, Xu, Xu, Xu, Xu, Xu, Xu
Xu, Xu, Xu, Xu, Xu, Uh, Ur, Uu, Uh, Uh, Xu, Uu, Uu^Vud, Ww, Xu, Qxua, Ww, Qxua, Uu, Ww, Xu, Xu, Ww, Xu, Isa, Xu, Xu, Xu, Xu, Xu, Xu
Xu, Xu, Xu, Xu, Qxua, Uh, Isa, Isa, Uh, Xu, Qxua, Xu, Xu, Xu, Qxua, Qxua, Isa, Isa, Xu, Xu, Xu, Xu, Isa, Isa, Isa, Xu, Xu, Xu, Xu, Xu, Xu
Xu, Xu, Xu, Qxua, Cud, Cud, Isa, Uu, Uh, Xu, Qxua, Qxua, Qxua, Qxua, Qxua, Qxua, Isa, Xu, Xu, Uu, Ww, Uu, Xu, Wo, Xu, Xu, Xu, Xu, Xu, Xu, Xu
Xu, Xu, Xu, Xu, Kud, Uh, Uh, Uu, Uh, Uh, Uu^Vud, Qxua, Qxua, Qxua, Qxua, Ww, Ww, Xu, Isa, Wo, Xu, Xu, Wo, Ww, Uu, Uu, Wo, Xu, Xu, Xu, Xu
Xu, Xu, Xu, Ww, Cud, Uh, Isa, Ur, Uu, Ww, Qxua, Qxua, Qxua, Qxua, Ww, Uu, Uu, Isa, Uh, Isa, Xu, Qxua, Ww, Xu, Isa, Xu, Xu, Xu, Xu, Xu, Xu
Xu, Xu, Xu, Xu, Qxua, Cud, Isa, Ur, Uh, Uu, Uh, Qxua, Isa, Ur, Uh, Uu, Qxua, Qxua, Qxua, Qxua, Qxua, Qxua, Xu, Xu, Ww, Isa, Xu, Xu, Xu, Xu, Xu
Xu, Xu, Xu, Xu, Xu, Qxua, Qxua, Ur, Uu, Uu, Uu, Isa, Wwr, Isa, Xu, Uu, Uu, Ww, Ww, Qxua, Qxua, Xu, Qxua, Uu, Wo, Ww, Xu, Xu, Xu, Xu, Xu
Xu, Xu, Xu, Xu, Xu, Xu, Qxua, Qxua, Isa, Ww, Uu, Uh, Xu, Xu, Xu, Xu, Xu, Xu, Xu, Ww, Xu, Xu, Qxua, Wwr, Wo, Uh, Ww, Xu, Xu, Xu, Wo
Xu, Xu, Xu, Xu, Xu, Xu, Ww, Uh, Uh, Isa, Uh, Xu, Xu, Xu, Xu, Xu, Xu, Xu, Xu, Wo, Wo, Wo, Ww, Qxua, Qxua, Isa, Ww^Vm, Isa, Ww, Xu, Wo
Xu, Xu, Uu, Uu, Ww, Uu, Uh, Uu, Isa, Isa, Uh, Xu, Xu, Xu, Xu, Xu, Xu, Xu, Xu, Xu, Xu, Xu, Xu, Ww, Isa, Isa, Xu, Ww, Chw, Chw, Chw
Wo, Ww, Uh, Isa, Uh, Uh, Xu, Uu, Ur, Uu, Uh, Xu, Xu, Xu, Xu, Xu, Xu, Xu, Xu, Xu, Xu, Xu, Xu, Xu, Xu, Xu, Ww^Vm, Isa, Chw, 3 Khw, Wo
Wo, Wwr, Xu, Xu, Xu, Xu, Wwr, Isa, Uu^Vu, Uu, Ww, Xu, Xu, Xu, Xu, Xu, Xu, Xu, Xu, Xu, Xu, Xu, Xu, Xu, Xu, Xu, Uh, Ww, Chw, Ww, Wo
Xu, Xu, Xu, Xu, Xu, Uu, Isa, Ur, Uh, Isa, Xu, Xu, Xu, Xu, Xu, Xu, Xu, Xu, Xu, Xu, Xu, Xu, Xu, Xu, Xu, Ww, Xu, Uu, Xu, Wo, Wo
Xu, Xu, Xu, Xu, Xu, Isa, Ur, Ur, Uh, Xu, Xu, Xu, Xu, Xu, Xu, Xu, Xu, Xu, Xu, Xu, Xu, Xu, Xu, Xu, Xu, Wo, Xu, Xu, Xu, Xu, Xu
Xu, Xu, Xu, Xu, Xu, Cud, Cud, Cud, Xu, Xu, Xu, Xu, Xu, Xu, Xu, Xu, Xu, Xu, Xu, Xu, Xu, Xu, Xu, Xu, Xu, Xu, Xu, Xu, Xu, Xu, Xu
Xu, Xu, Xu, Xu, Cud, Cud, Cud, Xu, Xu, Xu, Xu, Xu, Xu, Xu, Xu, Xu, Xu, Xu, Xu, Xu, Xu, Xu, Xu, Xu, Xu, Xu, Xu, Xu, Xu, Xu, Xu
Xu, Xu, Xu, Xu, Ww, 1 Kud, Ww, Xu, Xu, Xu, Xu, Xu, Xu, Xu, Xu, Xu, Xu, Xu, Xu, Xu, Xu, Xu, Xu, Xu, Xu, Xu, Xu, Xu, Xu, Xu, Xu
Xu, Xu, Ww, Ww, Ww, Ww, Xu, Xu, Xu, Xu, Xu, Xu, Xu, Xu, Xu, Xu, Xu, Xu, Xu, Xu, Xu, Xu, Xu, Xu, Xu, Xu, Xu, Xu, Xu, Xu, Xu
