Xu, Xu, Wo, Ww, Xu, Ww, Wo, Xu, Xu, Xu, Xu, Xu, Xu, Xu, Xu, Xu, Xu, Xu, Xu, Xu, Xu, Xu, Xu, Xu, Xu, Xu, Xu, Xu, Xu, Xu, Xu, Xu, Xu, Xu, Xu, Xu, Xu, Xu, Xu, Xu, Xu, Xu, Xu, Xu
Xu, Xu, Ww, Ww, Xu, Ww, Ww, Xu, Xu, Xu, Xu, Xu, Xu, Xu, Xu, Xu, Xu, Xu, Xu, Xu, Xu, Xu, Xu, Xu, Xu, Xu, Xu, Xu, Xu, Xu, Xu, Xu, Xu, Xu, Xu, Xu, Xu, Xu, Xu, Xu, Xu, Xu, Xu, Xu
Xu, Xu, Xu, Ww^Bw\r, Isa, Ww^Bw/r, Xu, Xu, Xu, Xu, Xu, Xu, Qxua, Xu, Xu, Xu, Xu, Xu, Xu, Xu, Xu, Xu, Xu, Xu, Xu, Xu, Xu, Xu, Xu, Xu, Xu, Xu, Xu, Xu, Xu, Xu, Xu, Xu, Xu, Xu, Xu, Xu, Xu, Xu
Xu, Xu, Uh, Uu, Isa, Isa^Edb, Isa^Xo, Xu, Xu, Xu, Uh, Uh, Uh^Em, Qxua, Uh, Xu, Xu, Xu, Xu, Xu, Uh, Xu, Xu, Xu, Xu, Xu, Xu, Xu, Xu, Xu, Xu, Xu, Uh^Emf, Qxua, Qxua, Xu, Xu, Xu, Xu, Xu, Xu, Xu, Xu, Xu
Xu, Xu, Xu, Uu, Xu, Xu, Xu, Isa, Isa, Ur, Cud, Cud, Cud, Uh^Em, Qxua, Uh, Uh, Xu, Uh, Uh, Uh^Em, Uu, Isa, Xu, Xu, Xu, Xu, Xu, Xu, Xu, Xu, Uh^Emf, Uu^Vud, Uh, Uh, Qxua, Xu, Xu, Xu, Xu, Xu, Xu, Xu, Xu
Xu, Xu, Xu, Xu, Xu, Xu, Uh, Uu, Isa, Ur, Cud, 2 Kud, Cud, Qxua^Ii, Uh, Uh, Ur, Uh, Ur, Uu^Em, Uu, Isa, Uu^Emf, Isa, Xu, Xu, Qxua, Qxua, Qxua, Qxua, Xu, Uu^Em, Ur, Isa^Edb, Isa^Edb, Qxua, Xu, Xu, Xu, Xu, Xu, Xu, Xu, Xu
Xu, Xu, Xu, Xu, Qxua, Qxu, Uu, Uu, Uu^Vu, Uh, Isa, Cud, Uu^Edb, Qxua, Uu, Uu^Vu, Uh^Edb, Ur, Uh, Uh, Isa, Uu, Uu, Xu, Uu^Edb, Ur^Edb, Qxua, Uh^Em, Uh^Em, Uh^Em, Xu, Ur, Xu, Uu, Xu, Xu, Xu, Xu, Xu, Xu, Xu, Xu, Xu, Xu
Xu, Xu, Xu, Xu, Xu, Uh, Ur, Ur, Uh, Uh^Em, Uu, Ur, Ur, Isa^Edb, Uu, Uu, Uh, Uu^Emf, Isa, Uu, Xu, Xu, Isa, Uu, Uu^Em, Ur^Edb, Qxua, Uh^Em, Qxua, Uh^Em, Uh, Ur, Xu, Xu, Xu, Xu, Xu, Xu, Xu, Xu, Xu, Xu, Xu, Xu
Xu, Xu, Xu, Xu, Xu, Xu, Xu, Uh^Emf, Xu, Uh, Uu, Uu, Uh, Uh, Uh, Uh, Uh, Uh, Uu, Uu, Xu, Isa, Uh, Uh^Emf, Uu^Em, Ur^Edb, Ur^Edb, Qxua, Isa, Uu, Uh, Uh, Xu, Xu, Xu, Xu, Xu, Xu, Xu, Xu, Xu, Xu, Xu, Xu
Xu, Xu, Xu, Xu, Xu, Xu, Xu, Xu, Ur, Ur, Uu, Uh^Emf, Uh^Emf, Uu, Uu, Xu, Xu, Uh, Xu, Xu, Xu, Isa, Uh^Em, Uh, Ur, Uu^Vu, Uh, Ur^Edb, Uh, Uu, Uu, Xu, Uh, Xu, Xu, Xu, Xu, Xu, Xu, Xu, Xu, Xu, Xu, Xu
Xu, Xu, Xu, Xu, Xu, Xu, Xu, Xu, Ur, Uu, Uu, Isa, Uu^Vu, Uu^Emf, Xu, Xu, Xu, Xu, Xu, Xu, Uh, Uh, Cud, Uh, Ur, Uu, Uh, Uh^Em, Xu, Xu, Isa, Isa, Uh^Em, Uh^Emf, Xu, Xu, Xu, Xu, Xu, Xu, Xu, Xu, Xu, Xu
Xu, Xu, Xu, Xu, Xu, Xu, Xu, Xu, Xu, Ur, Xu, Xu, Xu, Isa, Isa, Xu, Xu, Xu, Xu, Xu, Uh^Em, Cud, Kud, Cud, Uh^Em, Uh, Xu, Xu, Uh^Em, Uh, Isa, Uu^Emf, Uu^Em, Uh^Em, Xu, Xu, Xu, Xu, Xu, Xu, Xu, Xu, Xu, Xu
Xu, Xu, Xu, Xu, Xu, Xu, Xu, Xu, Uu^Em, Xu, Isa^Edb, Uh^Emf, Uh, Uh, Uu, Uh^Emf, Xu, Xu, Xu, Xu, Qxu, Cud, Cud, Cud, Uh^Em, Xu, Xu, Xu, Uh^Em, Uh^Em, Cud, Ur^Edb, Ur^Edb, Uh^Em, Xu, Xu, Xu, Xu, Xu, Xu, Xu, Xu, Xu, Xu
Xu, Xu, Xu, Xu, Xu, Xu, Uh, Uu^Em, Uh, Isa^Edb, Uu, Uu^Vu, Uu, Isa, Uu, Ur, Xu, Xu, Xu, Xu, Qxua, Uu, Uh^Emf, Uh^Em, Xu, Xu, Qxu, Xu, Uh^Em, Cud, 3 Kud, Cud, Ur^Edb, Uh, Xu, Xu, Xu, Xu, Xu, Xu, Xu, Xu, Xu, Xu
Xu, Xu, Xu, Xu, Xu, Xu, Qxua, Uh, Uh, Isa, Uu^Em, Uu, Uu, Uu, Ur, Ur, Xu, Xu, Xu, Xu, Xu, Uh, Uh^Em, Uh, Xu, Qxua, Uh, Qxu, Isa, Cud, Cud, Cud, Ur^Edb, Uh^Emf, Xu, Xu, Xu, Xu, Xu, Xu, Xu, Xu, Xu, Xu
Xu, Xu, Xu, Xu, Xu, Xu, Qxua, Qxua, Uu, Uu^Emf, Uh^Emf, Isa, Isa, Isa, Xu, Xu, Xu, Xu, Xu, Xu, Xu, Xu, Xu, Xu, Xu, Uh, Uu^Vu, Uu, Isa, Isa^Edb, Uu, Uu, Uh, Uh, Xu, Xu, Xu, Xu, Xu, Xu, Xu, Xu, Xu, Xu
Xu, Xu, Xu, Xu, Uh, Xu, Uu, Uu, Isa, Isa, Uh^Em, Uh, Xu, Xu, Xu, Xu, Xu, Xu, Xu, Xu, Xu, Xu, Xu, Xu, Qxua, Uu, Uu^Edb, Uu, Uh^Em, Uh^Em, Uh, Uu^Vu, Xu, Xu, Xu, Xu, Xu, Xu, Xu, Xu, Xu, Xu, Xu, Xu
Xu, Xu, Xu, Xu, Uh^Emf, Uh^Em, Isa, Isa, Uh, Uh^Emf, Uh, Isa, Xu, Xu, Xu, Xu, Xu, Xu, Xu, Xu, Xu, Xu, Xu, Xu, Qxua, Isa, Isa, Uu^Emf, Uh^Em, Uu^Vu, Uh, Xu, Xu, Xu, Xu, Xu, Xu, Xu, Xu, Xu, Xu, Xu, Xu, Xu
Xu, Xu, Xu, Xu, Xu, Isa, Uu^Emf, Uu^Vu, Qxua^Ii, Uu^Em, Uu^Em, Isa, Uh, Xu, Xu, Xu, Xu, Xu, Xu, Xu, Xu, Xu, Xu, Xu, Xu, Qxua, Isa, Uu, Isa^Em, Uh^Emf, Uh, Isa^Edb, Isa^Edb, Xu, Xu, Xu, Xu, Xu, Xu, Xu, Xu, Xu, Xu, Xu
Xu, Xu, Xu, Xu, Qxua, Uu, Cud, Uu^Edb, Uh^Edb, Qxua, Uh, Uh, Uh, Uh, Uh^Emf, Xu, Xu, Xu, Xu, Xu, Xu, Xu, Xu, Xu, Xu, Xu, Xu, Uu, Isa^Edb, Uh, Uu, Uu, Uu, Xu, Xu, Xu, Xu, Xu, Xu, Xu, Xu, Xu, Xu, Xu
Xu, Xu, Xu, Xu, Isa^Edb, Cud, 4 Kud, Cud, Isa^Edb, Isa, Isa, Uh, Isa^Edb, Isa^Emf, Uh^Em, Xu, Xu, Xu, Xu, Xu, Xu, Xu, Xu, Xu, Xu, Xu, Xu, Uu, Uu, Isa, Uu^Vu, Uu, Isa, Xu, Uh^Emf, Xu, Xu, Xu, Xu, Xu, Xu, Xu, Xu, Xu
Xu, Xu, Xu, Uh^Emf, Uu^Edb, Cud, Cud, Cud, Uu^Em, Uu^Em, Uu, Isa^Edb, Uu^Vu, Isa^Edb, Isa, Xu, Xu, Xu, Xu, Xu, Xu, Xu, Xu, Xu, Xu, Xu, Xu, Xu, Xu, Isa, Xu, Xu, Isa, Uu, Isa^Edb, Uh, Uh^Emf, Xu, Xu, Xu, Xu, Xu, Xu, Xu
Xu, Xu, Xu, Uh^Emf, Uu^Edb, Qxua, Qxua, Qxua, Ur, Uu^Emf, Uu, Uu, Uu, Uu^Em, Xu, Xu, Uh, Xu, Uh, Xu, Xu, Xu, Xu, Xu, Xu, Xu, Xu, Xu, Xu, Xu, Uh, Uu, Uu, Uu, Ur, Uh^Edb, Uh^Edb, Xu, Xu, Xu, Xu, Xu, Xu, Xu
Xu, Xu, Xu, Uh, Xu, Ur, Ur, Ur, Xu, Ur, Ur, Ur, Xu, Isa, Uu, Uh, Isa, Uu^Edb, Uu^Edb, Uh, Uh, Uu, Uh, Xu, Qxu, Qxu, Uh, Qxua, Xu, Uh, Isa, Uh, Uh, Uh, Qxu, Ur, Uu^Emf, Xu, Xu, Xu, Xu, Xu, Xu, Xu
Xu, Xu, Xu, Isa^Edb, Isa^Edb, Xu, Xu, Xu, Xu, Xu, Xu, Xu, Uu^Emf, Uu^Edb, Uu, Isa, Uh^Emf, Isa, Uu, Uu, Ur, Uh, Uh^Edb, Qxu, Uh^Emf, Uh^Emf, Isa^Edb, Uh, Uu^Vu, Xu, Qxua, Qxua, Qxua, Ur, Ur, Ur, Uh^Emf, Uh^Emf, Xu, Xu, Xu, Xu, Xu, Xu
Xu, Xu, Xu, Uu^Vud, Isa^Edb, Uh, Qxua, Xu, Xu, Xu, Xu, Xu, Uh, Isa^Edb, Ur, Uu, Uu^Em, Uh^Emf, Qxu, Uh, Uh, Ur, Uu^Edb, Uh^Em, Uu^Emf, Isa^Edb, Uu, Isa^Edb, Isa^Edb, Isa, Uh, Uh, Ur, Ur, Uu, Uh^Emf, Uh^Edb, Xu, Xu, Xu, Xu, Xu, Xu, Xu
Xu, Xu, Xu, Uu^Emf, Uh^Emf, Uh^Emf, Qxua, Xu, Xu, Xu, Xu, Xu, Xu, Uh, Ur, Ur, Isa^Edb, Uu^Em, Isa, Qxu, Uh, Ur, Uu, Uu, Qxu, Uu, Qxua, Isa^Edb, Ur, Uu^Edb, Uu, Uu, Uu, Uu, Isa, Uh, Xu, Xu, Xu, Xu, Xu, Xu, Xu, Xu
Xu, Xu, Xu, Xu, Xu, Qxua, Xu, Xu, Xu, Xu, Xu, Xu, Xu, Qxu, Uu^Emf, Uu, Uu, Uu^Vu, Uu, Uh, Ur, Ur, Uu^Em, Uh^Em, Uh, Uu^Vu, Qxua, Uh, Uh, Ur, Ur, Ur, Uh^Emf, Uu, Isa^Edb, Xu, Xu, Xu, Xu, Xu, Xu, Xu, Xu, Xu
Xu, Xu, Xu, Xu, Xu, Xu, Xu, Xu, Xu, Xu, Xu, Xu, Qxua, Qxua, Qxua, Uu^Em, Cud, Cud, Cud, Uu, Qxu, Uu, Uu^Em, Uu^Emf, Uu, Qxua, Xu, Xu, Xu, Uh^Emf, Uh, Uh, Uh^Em, Uu^Vu, Isa^Edb, Xu, Xu, Xu, Xu, Xu, Xu, Xu, Xu, Xu
Xu, Xu, Xu, Xu, Xu, Xu, Xu, Xu, Qxua, Qxua^Ii, Qxua^Ii, Qxua, Xu, Xu, Xu, Isa, Cud, Kud, Cud, Uu^Emf, Uu^Em, Qxu, Qxua, Qxua, Xu, Xu, Xu, Xu, Xu, Xu, Cud, Cud, Cud, Isa, Isa^Edb, Xu, Xu, Xu, Xu, Xu, Xu, Xu, Xu, Xu
Xu, Xu, Xu, Xu, Xu, Xu, Xu, Xu, Qxua, Urc, Qxua, Xu, Xu, Xu, Xu, Xu, Xu, Cud, Xu, Xu, Xu, Xu, Xu, Xu, Xu, Xu, Xu, Xu, Xu, Xu, Cud, 1 Kud, Cud, Qxua, Ur, Uu^Vu, Uh, Uh, Xu, Xu, Xu, Xu, Xu, Xu
Xu, Xu, Xu, Xu, Xu, Xu, Xu, Xu, Xu, Qxua, Xu, Xu, Xu, Xu, Xu, Xu, Xu, Xu, Xu, Xu, Xu, Xu, Xu, Xu, Xu, Xu, Xu, Xu, Xu, Xu, Uh^Ii, Cud, Uh^Edb, Ur, Xu, Uh, Xu, Xu, Xu, Xu, Xu, Xu, Xu, Xu
Xu, Xu, Xu, Xu, Xu, Xu, Xu, Xu, Xu, Xu, Xu, Xu, Xu, Xu, Xu, Xu, Xu, Xu, Xu, Xu, Xu, Xu, Xu, Xu, Xu, Xu, Xu, Xu, Xu, Xu, Uh, Isa^Edb, Uu^Edb, Xu, Xu, Xu, Xu, Xu, Xu, Xu, Xu, Xu, Xu, Xu
Xu, Xu, Xu, Xu, Xu, Xu, Xu, Xu, Xu, Xu, Xu, Xu, Xu, Xu, Xu, Xu, Xu, Xu, Xu, Xu, Xu, Xu, Xu, Xu, Xu, Xu, Xu, Xu, Xu, Xu, Uh^Ii, Isa^Ii, Uu^Ii, Xu, Xu, Xu, Xu, Xu, Xu, Xu, Xu, Xu, Xu, Xu
